Word	Katakana	Emotion	
哀	アイ	悲	
愛	アイ	好	
相いれない	アイイレナイ	嫌	
哀感	アイカン	悲	
愛敬	アイキョウ	好親	
愛好	アイコウ	好	
哀愁	アイシュウ	寂	
愛執	アイシュウ	好親	
哀傷	アイショウ	悲	
愛情	アイジョウ	好	
愛する	アイスル	好	
哀惜	アイセキ	悲	
哀切	アイセツ	悲	
愛想を尽かす	アイソオツカス	あ失	
愛着	アイチャク	好親	
哀悼	アイトウ	悲	
愛慕	アイボ	好	
愛欲	アイヨク	好	
愛らしい	アイラシイ	安親好	
青息吐息	アオイキトイキ	失	
仰ぐ	アオグ	尊	
青筋を立てる	アオスジヲタテル	怒	
赤恥	アカッパジ	恥	
赤らむ	アカラム	恥	
赤らめる	アカラメル	恥	
崇める	アガメル	尊	
飽き飽き	アキアキ	不怠	
飽き足りる	アキタリル	不	
諦め	アキラメ	辛失	
諦める	アキラメル	辛失	
飽きる	アキル	Ｆ失	
呆れ返る	アキレカエル	あ	
呆れ果てる	アキレハテル	あ	
呆れる	アキレル	あ	
悪感情	アクカンジョウ	嫌	
倦む	アグム	Ｆ不	
憧れ	アコガレ	尊	
憧れる	アコガレル	尊	
浅ましい	アサマシイ	嫌	
嘲る	アザケル	嫌	
味気ない	アジケナイ	Ｆ	
焦り	アセリ	焦	
焦る	アセル	焦	
唖然	アゼン	困あ	
頭に来る	アタマニクル	怒	
頭を悩ませる	アタマヲナヤマセル	悩困	
当たり散らす	アタリチラス	怒	
あッ	アッ	驚	
あっけない	アッケナイ	あＦ残	
呆気に取られる	アッケニトラレル	困あ	
圧迫感	アッパクカン	怖	
熱い	アツイ	興	
熱いものがこみ上げる	アツイモノガコミアゲル	興	
厚かましい	アツカマシイ	嫌	
熱くなる	アツクナル	興	
暑苦しい	アツクルシイ	嫌Ｆ	
後味が良くない	アトアジガヨクナイ	Ｆ	
後味が宜しくない	アトアジガヨロシクナイ	Ｆ	
後味が悪い	アトアジガワルイ	Ｆ	
侮る	アナドル	見	
阿鼻叫喚	アビキョウカン	怖	
危ない	アブナイ	怖焦	
あほらしい	アホラシイ	困失	
荒々しい	アラアラシイ	怖	
あらッ	アラッ	驚	
ありがたい	アリガタイ	感	
ありがたみ	アリガタミ	感	
ありがた迷惑	アリガタメイワク	不	
ありがと	アリガト	感	
ありがとう	アリガトウ	感	
ありゃ	アリャ	驚	
慌てふためく	アワテフタメク	焦	
慌てる	アワテル	焦	
哀れ	アワレ	憐	
憐れ	アワレ	憐	
憐れみ	アワレミ	憐	
憐れむ	アワレム	憐	
安逸	アンイツ	楽	
暗鬱	アンウツ	Ｆ	
安閑	アンカン	穏	
案外	アンガイ	驚	
安心	アンシン	安穏	
案ずる	アンズル	心	
暗然	アンゼン	悲鬱	
安息感	アンソクカン	安穏	
暗澹	アンタン	失	
安定	アンテイ	穏	
安堵	アンド	安穏	
安寧	アンネイ	穏	
安楽	アンラク	安	
怡怡	イイ	喜楽	
言い寄る	イイヨル	親	
いかがわしい	イカガワシイ	嫌	
厳つい	イカツイ	怖	
怒らす	イカラス	怒	
怒り	イカリ	怒	
怒りが爆発する	イカリガバクハツスル	怒	
怒り狂う	イカリクルウ	怒	
遺憾	イカン	あ残	
意外	イガイ	驚	
啀み合う	イガミアウ	嫌	
啀む	イガム	嫌	
息を詰める	イキオツメル	辛苦	
息が詰まる	イキガツマル	辛苦	
息苦しい	イキグルシイ	辛苦	
息苦しさ	イキグルシサ	辛苦	
意気軒昂	イキケンコウ	興	
意気消沈	イキショウチン	鬱失	
憤り	イキドオリ	怒	
憤る	イキドオル	怒	
行き悩む	イキナヤム	悩	
生き恥	イキハジ	恥	
息巻く	イキマク	怒	
熱り立つ	イキリタツ	興	
息を飲む	イキヲノム	興緊	
息を潜める	イキヲヒソメル	怖	
いけ好かない	イケスカナイ	嫌	
いけ図々しい	イケズウズウシイ	嫌	
依怙地になる	イコジニナル	見	
遺恨	イコン	恨	
勇ましい	イサマシイ	尊	
意趣	イシュ	恨	
萎縮	イシュク	き恥	
意地汚い	イジキタナイ	嫌	
意地悪	イジワル	嫌	
いそいそ	イソイソ	喜	
意想外	イソウガイ	驚	
痛い	イタイ	辛苦	
痛々しい	イタイタシイ	憐	
居た堪れない	イタタマレナイ	憐	
痛ましい	イタマシイ	憐	
痛み	イタミ	辛苦	
痛み入る	イタミイル	恐	
悼む	イタム	悲憐	
痛める	イタメル	辛苦	
いちゃもんを付ける	イチャモンヲツケル	不怒	
一憂	イチユウ	鬱	
一喜	イッキ	喜	
一驚	イッキョウ	驚	
慈しみ	イツクシミ	安穏	
慈しむ	イツクシム	安穏	
逸楽	イツラク	喜楽	
厭う	イトウ	嫌	
愛おしい	イトオシイ	安親	
愛おしむ	イトオシム	安親	
愛しい	イトシイ	安親	
愛しがる	イトシガル	好	
愛しさ	イトシサ	安親	
厭わしい	イトワシイ	嫌	
厭わしさ	イトワシサ	嫌	
畏怖	イフ	怖	
忌忌しい	イマイマシイ	嫌	
忌忌しがる	イマイマシガル	嫌	
忌まわしい	イマワシイ	嫌	
忌み嫌う	イミキラウ	嫌	
忌む	イム	切	
嫌	イヤ	嫌	
厭	イヤ	嫌	
厭厭	イヤイヤ	嫌	
厭がる	イヤガル	嫌	
嫌気	イヤケ	嫌	
卑しい	イヤシイ	嫌	
卑しむ	イヤシム	嫌	
嫌味	イヤミ	嫌	
厭らしい	イヤラシイ	嫌	
苛苛しい	イライラシイ	不	
苛苛する	イライラスル	不	
苛立たしい	イラダタシイ	不	
苛立たしさ	イラダタシサ	不	
苛立ち	イラダチ	不	
苛立つ	イラダツ	不	
苛立てる	イラダテル	不	
色を失う	イロヲウシナウ	心怖	
色をなす	イロヲナス	怒	
陰鬱	インウツ	Ｆ鬱	
陰気	インキ	Ｆ嫌	
陰気臭い	インキクサイ	嫌	
陰惨	インサン	怖	
陰湿	インシツ	嫌	
浮かされる	ウカサレル	興好	
浮かぬ顔	ウカヌカオ	困	
浮かれる	ウカレル	興喜	
浮き足立つ	ウキアシタツ	怖不	
うきうきする	ウキウキスル	興喜	
浮き立つ	ウキタツ	興喜	
憂き目	ウキメ	悲	
憂さ	ウサ	鬱	
胡散臭い	ウサンクサイ	困嫌	
後ろめたい	ウシロメタイ	不心	
後ろめたさ	ウシロメタサ	不心	
薄気味悪い	ウスキミワルイ	怖	
薄汚い	ウスギタナイ	嫌	
うずうず	ウズウズ	興	
打ち萎れる	ウチシオレル	失	
打ち拉がれる	ウチヒシガレル	失	
有頂天	ウチョウテン	喜	
鬱気	ウッキ	鬱	
鬱屈	ウックツ	鬱	
鬱散	ウッサン	気	
鬱積	ウッセキ	不	
鬱陶しい	ウットウシイ	嫌	
鬱陶しさ	ウットウシサ	嫌	
うっとり	ウットリ	楽気	
鬱憤	ウップン	不	
鬱	ウツ	鬱	
鬱鬱と	ウツウツト	鬱	
俯き	ウツムキ	鬱	
俯く	ウツムク	鬱	
鬱悶	ウツモン	鬱悩苦	
虚	ウツロ	鬱	
疎ましい	ウトマシイ	嫌	
疎む	ウトム	嫌	
疎んじる	ウトンジル	嫌	
疎んずる	ウトンズル	嫌	
美味い	ウマイ	喜	
旨い	ウマイ	喜	
上手い	ウマイ	尊	
呻き声	ウメキゴエ	怖	
呻く	ウメク	辛苦	
敬う	ウヤマウ	尊	
うら悲しい	ウラガナシイ	悲	
うら淋しい	ウラサビシイ	寂	
うら寂しい	ウラサビシイ	寂	
恨み	ウラミ	恨	
恨みがましい	ウラミガマシイ	恨	
恨む	ウラム	恨	
恨めしい	ウラメシイ	恨	
恨めしがる	ウラメシガル	恨	
恨めしく思う	ウラメシクオモウ	恨	
羨ましい	ウラヤマシイ	不	
羨ましがる	ウラヤマシガル	不	
羨む	ウラヤム	不	
五月蝿い	ウルサイ	嫌	
麗しい	ウルワシイ	尊	
憂い	ウレイ	鬱	
愁い	ウレイ	鬱	
愁え	ウレイ	鬱	
憂える	ウレエル	鬱	
嬉しい	ウレシイ	喜	
嬉しかった	ウレシカッタ	喜	
嬉しがらせ	ウレシガラセ	喜	
嬉しがらせる	ウレシガラセル	喜	
嬉しがる	ウレシガル	喜	
嬉しさ	ウレシサ	喜	
嬉し泣き	ウレシナキ	喜	
嬉し涙	ウレシナミダ	喜	
嬉しみ	ウレシミ	喜	
憂わしい	ウレワシイ	鬱	
狼狽える	ウロタエル	困	
上擦る	ウワズル	興	
うんざり	ウンザリ	Ｆ	
詠嘆	エイタン	動	
笑顔	エガオ	気	
依怙贔屓	エコヒイキ	嫌	
えッ	エッ	驚	
悦	エツ	喜	
笑壺に入る	エツボニハイル	喜	
悦楽	エツラク	喜	
恵比寿顔	エビスガオ	喜	
笑み	エミ	気	
笑む	エム	気	
厭悪	エンオ	嫌	
怨恨	エンコン	恨	
怨嗟	エンサ	恨	
怨色	エンショク	恨	
えーっ	エーッ	驚	
おいおい	オイオイ	あ	
美味しい	オイシイ	喜	
謳歌	オウカ	喜	
嘔吐	オウト	辛苦	
懊悩	オウノウ	悩	
大恥	オウハジ	恥	
大喜び	オウヨロコビ	喜	
嗚咽	オエツ	苦	
おぉ	オォ	驚	
おお	オオ	驚	
男男しい	オオシイ	尊	
岡惚れ	オカボレ	好	
岡焼き	オカヤキ	妬	
御気に入り	オキニイリ	喜楽	
お気に入り	オキニハイリ	好	
臆する	オクスル	怖	
臆病	オクビョウ	怖	
臆面	オクメン	ふ	
臆面もなく	オクメンモナク	尊	
怒らせる	オコラセル	怒	
怒り出す	オコリダス	怒	
怒り付ける	オコリツケル	怒	
怒る	オコル	怒	
惜しい	オシイ	残悔	
惜しがる	オシガル	残悔	
惜し気	オシゲ	残悔	
押し付けがましい	オシツケガマシイ	嫌	
惜しむ	オシム	残悔	
怖気付く	オジケツク	怖	
汚辱	オジョク	恥	
恐る恐る	オソルオソル	怖	
恐れ	オソレ	怖	
恐れ入る	オソレイル	怖	
恐れ多い	オソレオオイ	怖	
恐れる	オソレル	怖	
恐ろしい	オソロシイ	怖	
恐ろしがる	オソロシガル	怖	
恐ろしさ	オソロシサ	怖	
おぞましい	オゾマシイ	怖	
落ち着かない	オチツカナイ	興	
落ち着き	オチツキ	安	
落ち着き払う	オチツキハラウ	安	
落ち着く	オチツク	穏	
落ち着ける	オチツケル	穏	
おっ	オッ	驚	
おっかない	オッカナイ	怖	
躍り上がる	オドリアガル	喜驚	
おどろおどろしい	オドロオドロシイ	怖	
驚かす	オドロカス	驚	
驚き	オドロキ	驚	
驚き呆れる	オドロキアキレル	驚あ	
驚き入る	オドロキイル	驚	
驚く	オドロク	驚	
戦き	オノノキ	怖	
戦く	オノノク	怖	
怯え	オビエ	怖	
怯え切る	オビエキル	怖	
怯える	オビエル	怖	
思し召す	オボシメス	尊	
溺れる	オボレル	辛苦	
怖めず臆せず	オメズオクセズ	誇	
おめでたい	オメデタイ	祝	
おめでとう	オメデトウ	祝	
おもいがけない	オモイガケナイ	驚	
思い屈する	オモイクッスル	失	
思い焦がれる	オモイコガレル	好	
思い詰める	オモイツメル	悩	
思い悩む	オモイナヤム	悩	
思い残す	オモイノコス	悔	
思いの外	オモイノホカ	驚	
思い惑う	オモイマドウ	困	
思い迷う	オモイマヨウ	困	
思いも寄らず	オモイモヨラズ	驚	
思いも寄らない	オモイモヨラナイ	驚	
思いも寄らぬ	オモイモヨラヌ	驚	
思い遣り	オモイヤリ	心	
思い遣る	オモイヤル	心	
思い煩う	オモイワズラウ	心悩	
重苦しい	オモクルシイ	苦	
重苦しさ	オモクルシサ	苦	
面白い	オモシロイ	喜	
面白かった	オモシロカッタ	喜	
面白がる	オモシロガル	喜	
面白くない	オモシロクナイ	不	
面憎い	オモニクイ	憎	
重荷を下ろす	オモニヲオロス	安穏	
面映い	オモハユイ	恥	
おもろい	オモロイ	喜	
重んじる	オモンジル	尊	
親心	オヤゴコロ	心	
おろおろ	オロオロ	焦困悲	
愚か	オロカ	嫌見	
おろかしい	オロカシイ	嫌見	
愚かしい	オロカシイ	嫌見	
恩愛	オンアイ	好	
恩寵	オンチョウ	好	
怨念	オンネン	恨	
快感	カイカン	気	
怪奇	カイキ	怖	
懐旧	カイキュウ	切	
懐郷	カイキョウ	切	
懐古	カイコ	切	
悔恨	カイコン	悔	
悔悟	カイゴ	悔	
快哉	カイサイ	気	
快楽	カイラク	気	
顔を赤らめる	カオオアカラメル	恥	
顔を隠す	カオオカクス	恥	
顔を曇らせる	カオオクモラセル	困	
顔をしかめる	カオオシカメル	困	
顔から火が出る	カオカラヒガデル	恥	
顔が火照る	カオガホテル	恥	
掻き暗れる	カキクレル	悲	
掻き毟られる	カキムシラレル	悩	
隔意	カクイ	恐	
鶴首	カクシュ	願	
嚇怒	カクド	怒	
かぐわしい	カグワシイ	好	
陰る	カゲル	悩失	
風向きが悪い	カザムキガワルイ	失	
畏まる	カシコマル	恐	
呵責	カシャク	嫌	
片恨み	カタウラミ	恨	
肩を落とす	カタオオトス	失	
片想い	カタオモイ	好	
固くなる	カタクナル	恐	
堅苦しい	カタクルシイ	不恐	
かたじけない	カタジケナイ	感	
肩の荷が下りる	カタノニガオリル	安穏	
片腹痛い	カタハライタイ	喜	
肩身が狭い	カタミガセマイ	不Ｆ	
肩身が広い	カタミガヒロイ	誇	
かちっと来る	カチットクル	怒	
勝ち誇る	カチホコル	誇	
隔靴掻痒	カッカソウヨウ	悔	
かったるい	カッタルイ	困	
渇望	カツボウ	願	
哀しい	カナシイ	悲	
悲しい	カナシイ	悲	
悲しがる	カナシガル	悲	
悲しさ	カナシサ	悲	
哀しさ	カナシサ	悲	
悲しまれる	カナシマレル	悲	
悲しみ	カナシミ	悲	
悲しむ	カナシム	悲	
叶わない	カナワナイ	悔失	
雷に打たれる	カミナリニウタレル	驚	
絡む	カラム	嫌	
軽がろしい	カロガロシイ	見	
軽んじる	カロンジル	見	
軽んずる	カロンズル	嫌	
可愛がる	カワイガル	安	
可哀想	カワイソウ	憐	
奸悪	カンアク	嫌	
感悦	カンエツ	喜	
感慨	カンガイ	動	
感慨無量	カンガイムリョウ	動	
汗顔	カンガン	恥	
歓喜	カンキ	喜	
感泣	カンキュウ	動	
感興	カンキョウ	願	
感極まる	カンキワマル	動	
艱苦	カンク	苦悩	
感激	カンゲキ	動	
歓呼	カンコ	喜	
感謝	カンシャ	感	
癇癪	カンシャク	怒	
感傷	カンショウ	あ悲	
歓笑	カンショウ	喜	
歓心	カンシン	喜	
寒心	カンシン	怖	
感心	カンシン	動	
莞爾	カンジ	喜	
感じ入る	カンジイル	尊	
感情的	カンジョウテキ	興	
感情を害する	カンジョウヲガイスル	Ｆ	
感情を昂らせる	カンジョウヲタカブラセル	興	
歓声	カンセイ	喜	
感嘆	カンタン	尊動	
歓天喜地	カンテンキチ	喜	
感動	カンドウ	動	
感に堪える	カンニコタエル	動	
癇に障る	カンニサワル	嫌	
感に堪えない	カンニタエナイ	動	
勘忍袋の緒が切れる	カンニンブクロノオガキレル	怒	
感服	カンプク	尊動	
感無量	カンムリョウ	動	
感銘	カンメイ	動	
寛容	カンヨウ	親	
歓楽	カンラク	喜楽	
感涙	カンルイ	動	
歓を尽くす	カンヲツクス	楽	
賀意	ガイ	祝	
慨然	ガイゼン	怒鬱悲興	
慨嘆	ガイタン	悲怒	
愕然	ガクゼン	驚	
がっかり	ガッカリ	驚	
がっくり	ガックリ	失	
我慢ならない	ガマンナラナイ	興	
がみがみ	ガミガミ	嫌	
がめつい	ガメツイ	見嫌	
気鬱	キウツ	鬱	
消え入りたい	キエイリタイ	恥	
喜悦	キエツ	喜	
気後れ	キオクレ	恐	
気落ち	キオチ	失	
気を揉む	キオモム	心	
気を悪くする	キオワルクスル	Ｆ	
気がある	キガアル	好	
気が置かれる	キガオカレル	恐	
気が重い	キガオモイ	鬱	
気懸かり	キガカリ	心	
気が軽い	キガカルイ	気	
気が気でない	キガキデナイ	心興	
気が沈む	キガシズム	失	
気が急く	キガセク	焦	
気が立つ	キガタツ	興	
気が咎める	キガトガメル	た	
気兼ね	キガネ	恐	
気が引き締まる	キガヒキシマル	緊	
気が参る	キガマイル	Ｆ	
気が滅入る	キガメイル	鬱	
気が揉める	キガモメル	興心	
気が緩む	キガユルム	安穏	
気が楽	キガラク	安穏	
気軽	キガル	親安	
気軽い	キガルイ	親安	
嬉嬉	キキ	喜	
聞き苦しい	キキグルシイ	不	
聞き捨てならない	キキズテナラナイ	困	
聞き辛い	キキズライ	不	
聞きにくい	キキニクイ	不	
危懼	キク	怖	
危惧	キグ	怖	
気苦労	キグロウ	心	
危険	キケン	怖	
機嫌好い	キゲンヨイ	気	
きざっぽい	キザッポイ	嫌	
気障り	キザワリ	嫌Ｆ	
キショい	キショイ	嫌Ｆ	
喜色	キショク	喜	
気色が悪い	キショクガワルイ	嫌Ｆ	
気色を害する	キショクヲガイスル	Ｆ	
気色を悪くする	キショクヲワルクスル	Ｆ	
傷痕	キズアト	苦	
気遣い	キズカイ	恐	
気遣う	キズカウ	恐	
気遣わしい	キズカワシイ	恐	
傷付く	キズツク	辛苦	
気忙しい	キゼワシイ	辛	
気忙しさ	キゼワシサ	辛	
汚い	キタナイ	嫌	
汚らしい	キタナラシイ	嫌	
狐に撮まれたよう	キツネニツママレタヨウ	驚	
気詰まり	キヅマリ	き	
気に入る	キニイル	興好	
気に食わない	キニクワナイ	嫌	
気に障る	キニサワル	Ｆ	
気になる	キニナル	悩	
気に入らない	キニハイラナイ	嫌	
気に病む	キニヤム	心	
気抜け	キヌケ	怠	
気の毒	キノドク	憐	
気恥ずかしい	キハズカシイ	恥	
気恥ずかしさ	キハズカシサ	恥	
厳しい	キビシイ	怖	
気塞ぎ	キフサギ	鬱	
気分が和む	キブンガナゴム	安穏	
気分が弾む	キブンガハズム	喜	
気まずい	キマズイ	き	
気まずさ	キマズサ	き	
きまりが悪い	キマリガワルイ	恥き	
気味が悪い	キミガワルイ	怖	
気味悪い	キミワルイ	怖	
気味悪さ	キミワルサ	Ｆ	
気持ちいい	キモチイイ	気	
気持ちが傷付けられる	キモチガキズツケラレル	苦	
気持ちが沈む	キモチガシズム	鬱	
気持ちが和む	キモチガナゴム	安穏	
気持ちが晴れる	キモチガハレル	気	
気持ちが晴れ渡る	キモチガハレワタル	気	
気持ちが好い	キモチガヨイ	気	
気持ちが悪くなる	キモチガワルクナル	辛	
気持ちの好いものではない	キモチノヨイモノデワナイ	Ｆ	
気持ちよい	キモチヨイ	気	
気持ち良い	キモチヨイ	気	
気持ち悪い	キモチワルイ	Ｆ	
肝を潰す	キモヲツブス	驚	
肝を冷やす	キモヲヒヤス	焦	
きゃあ	キャア	驚怖	
キャッ	キャッ	驚	
気安い	キヤスイ	安親	
窮屈	キュウクツ	Ｆ	
窮する	キュウスル	困苦	
杞憂	キユウ	心	
驚異	キョウイ	驚尊	
恐悦	キョウエツ	恐	
恭賀	キョウガ	祝	
驚愕	キョウガク	驚	
驚懼	キョウガク	驚	
興が醒める	キョウガサメル	失	
興がる	キョウガル	喜困	
狂喜	キョウキ	喜	
驚喜	キョウキ	喜驚	
恟恟	キョウキョウ	怖	
恐懼	キョウク	怖	
恐慌	キョウコウ	怖	
興醒め	キョウザメ	失	
興趣	キョウシュ	喜	
郷愁	キョウシュウ	切	
恐縮	キョウシュク	恐	
興じる	キョウジル	喜	
驚嘆	キョウタン	動驚	
驚天動地	キョウテンドウチ	驚	
驚倒	キョウトウ	驚	
恐怖	キョウフ	怖	
驚怖	キョウフ	驚怖	
恐怖感	キョウフカン	怖	
凶暴	キョウボウ	怖	
興味深い	キョウミブカイ	興	
享楽	キョウラク	楽	
狂恋	キョウレン	好興	
虚心坦懐	キョシンタンカイ	穏	
虚脱感	キョダツカン	鬱怠	
きょときょと	キョトキョト	不怖	
きょとんとする	キョトントスル	驚	
虚無	キョム	失	
嫌い	キライ	嫌	
嫌う	キラウ	嫌	
気楽	キラク	安楽穏	
気を腐らせる	キヲクサラセル	怠	
気を呑まれる	キヲノマレル	怖	
欣快	キンカイ	喜	
欣喜	キンキ	喜	
欣喜雀躍	キンキジャクヤク	喜	
欣欣	キンキン	喜	
欣幸	キンコウ	喜	
欣然	キンゼン	喜	
緊張	キンチョウ	緊	
緊張感	キンチョウカン	緊	
緊張がほどける	キンチョウガホドケル	穏	
緊迫	キンパク	焦緊	
欣慕	キンボ	喜	
欣躍	キンヤク	喜	
疑懼	ギク	怖	
ぎくっ	ギクッ	驚	
ぎくり	ギクリ	驚	
ぎっくり	ギックリ	驚	
義憤	ギフン	怒	
ぎゃあ	ギャア	苦驚怖	
逆上	ギャクジョウ	怒	
仰天	ギョウテン	驚	
御慶	ギョケイ	祝	
ぎょっとする	ギョットスル	驚	
苦	ク	苦	
悔い	クイ	悔	
悔いる	クイル	悔	
空虚	クウキョ	失	
臭い	クサイ	Ｆ	
腐る	クサル	Ｆ	
くしゃくしゃな顔	クシャクシャナカオ	悲	
苦笑	クショウ	Ｆ	
苦渋	クジュウ	困苦	
くすくす	クスクス	喜	
くすぐったい	クスグッタイ	喜	
くだらない	クダラナイ	見嫌	
口煩い	クチウルサイ	嫌	
口惜しい	クチオシイ	残悔	
くちぎたない	クチギタナイ	Ｆ	
唇を噛む	クチビルオカム	悔怒	
くちやかましい	クチヤカマシイ	嫌Ｆ	
苦衷	クチュウ	苦	
喰って掛かる	クッテカカル	怒	
苦痛	クツウ	苦	
屈辱	クツジョク	悔	
屈辱感	クツジョクカン	悔	
寛ぎ	クツロギ	穏	
寛ぐ	クツログ	穏	
寛げる	クツロゲル	穏	
くどい	クドイ	嫌	
苦悩	クノウ	苦	
首っ丈	クビッタケ	好興	
首をすくめる	クビヲスクメル	怖	
曇る	クモル	困悩	
苦悶	クモン	苦	
悔しい	クヤシイ	失	
悔しがる	クヤシガル	悔	
悔しさ	クヤシサ	悔	
悔し泣き	クヤシナキ	悔	
悔し涙	クヤシナミダ	悔	
悔み	クヤミ	悔	
悔む	クヤム	悔	
くよくよ	クヨクヨ	心悩	
暗い	クライ	心悩	
狂い怒る	クルイオコル	怒	
苦しい	クルシイ	苦	
苦しさ	クルシサ	苦	
苦しみ	クルシミ	苦	
苦しみ悶える	クルシミモダエル	苦	
苦しむ	クルシム	苦	
苦労	クロウ	辛	
具合が悪い	グアイガワルイ	Ｆ	
具合悪い	グアイワルイ	Ｆ	
愚図愚図	グズグズ	嫌	
愚図る	グズル	嫌困	
ぐっと来る	グットクル	動	
敬愛	ケイアイ	尊	
慶賀	ケイガ	祝	
慶祝	ケイシュク	祝	
慶する	ケイスル	祝	
傾倒	ケイトウ	好	
敬服	ケイフク	尊	
敬慕	ケイボ	尊	
気圧される	ケオサレル	怖	
汚らわしい	ケガラワシイ	嫌	
毛嫌い	ケギライ	嫌	
気色ばむ	ケシキバム	怒	
懸想	ケソウ	好	
気怠い	ケダルイ	怠	
血相を変える	ケッソウヲカエル	怒	
血涙	ケツルイ	悲怒	
懸念	ケネン	心	
けばけばしい	ケバケバシイ	嫌	
煙い	ケムイ	Ｆ	
煙たい	ケムタイ	Ｆ	
けろっ	ケロッ	楽	
けろり	ケロリ	楽	
慊焉	ケンエン	不気	
倦厭	ケンエン	Ｆ怠	
嫌悪	ケンオ	嫌	
嫌悪感	ケンオカン	嫌	
嫌忌	ケンキ	嫌	
倦怠	ケンタイ	嫌	
倦怠感	ケンタイカン	怠	
権幕	ケンマク	興	
激越	ゲキエツ	興	
激語	ゲキゴ	興	
激賞	ゲキショウ	興	
激情	ゲキジョウ	興	
激する	ゲキスル	興	
激怒	ゲキド	怒	
激憤	ゲキフン	怒	
逆鱗に触れる	ゲキリンニフレル	怒	
げっ	ゲッ	驚焦	
激昂	ゲッコウ	怒	
げっそり	ゲッソリ	失怠	
下品	ゲヒン	嫌	
下劣	ゲレツ	嫌	
元気	ゲンキ	気	
減退	ゲンタイ	失	
げんなり	ゲンナリ	失怠	
幻滅	ゲンメツ	失	
恋	コイ	好	
恋い焦がれる	コイコガレル	苦好	
恋心	コイゴコロ	好	
恋しい	コイシイ	好	
恋しさ	コイシサ	好	
恋する	コイスル	好	
冀う	コイネガウ	願	
恋う	コウ	好	
厚意	コウイ	親	
好意	コウイ	好	
光栄	コウエイ	気恐	
厚恩	コウオン	感	
後悔	コウカイ	悔	
交歓	コウカン	親	
好感	コウカン	好	
慷慨	コウガイ	怒	
好機	コウキ	喜	
耿耿	コウコウ	鬱心	
恍惚	コウコツ	好興	
恍惚感	コウコツカン	好興	
厚志	コウシ	感	
昂進	コウシン	興	
厚情	コウジョウ	感	
困じる	コウジル	困	
困ずる	コウズル	困	
昂然	コウゼン	誇	
浩然	コウゼン	安穏	
紅潮	コウチョウ	恥	
幸福	コウフク	幸	
幸福感	コウフクカン	幸	
公憤	コウフン	怒	
興奮	コウフン	興	
昂揚	コウヨウ	興	
荒涼	コウリョウ	失	
紅涙	コウルイ	悲	
小煩い	コウルサイ	Ｆ	
声を荒立てる	コエオアラダテル	興	
声が潤む	コエガウルム	悲	
小躍り	コオドリ	喜	
焦がれる	コガレル	苦	
小汚い	コギタナイ	嫌	
酷悪	コクアク	嫌	
焦げ臭い	コゲクサイ	Ｆ	
心地良い	ココチヨイ	安穏	
心地良さ	ココチヨサ	安穏	
心憂い	ココロウレイ	鬱	
心後れ	ココロオクレ	鬱	
心悲しい	ココロカナシイ	悲	
心悲しさ	ココロカナシサ	悲	
心が痛む	ココロガイタム	苦	
心が動かされる	ココロガウゴカサレル	動	
心が重い	ココロガオモイ	苦悩	
心懸かり	ココロガカリ	悩	
心が傷付く	ココロガキズツク	苦	
心が傷付けられる	ココロガキズツケラレル	苦	
心が弾む	ココロガハズム	楽喜	
心が張り詰める	ココロガハリツメル	緊	
心が細る	ココロガホソル	悩	
心苦しい	ココログルシイ	苦	
心苦しさ	ココログルシサ	苦	
心淋しい	ココロサビシイ	寂	
心遣い	ココロズカイ	心	
心強い	ココロズヨイ	安穏	
心憎い	ココロニクイ	憎	
心の痛み	ココロノイタミ	辛苦	
心の傷	ココロノキズ	辛苦	
心残り	ココロノコリ	ふ	
心細い	ココロボソイ	ふ	
心細さ	ココロボソサ	ふ	
心持ちが好くない	ココロモチガヨクナイ	Ｆ	
心持ちが悪い	ココロモチガワルイ	Ｆ	
心許ない	ココロモトナイ	ふ	
心安い	ココロヤスイ	親	
心行く	ココロユク	気	
快い	ココロヨイ	気	
快く思わない	ココロヨクオモワナイ	嫌	
心を奪われる	ココロヲウバワレル	好	
心を砕く	ココロヲクダク	苦	
心を遣る	ココロヲヤル	心気	
小淋しい	コサビシイ	寂	
小賢しい	コザカシイ	嫌	
腰を抜かす	コシオヌカス	驚	
小癪	コシャク	嫌	
小突かれる	コズカレル	驚	
姑息	コソク	嫌	
こそばゆい	コソバユイ	喜	
小面憎い	コヅラニクイ	嫌憎	
孤独	コドク	寂	
孤独感	コドクカン	寂	
小憎らしい	コニクラシイ	嫌憎	
好ましい	コノマシイ	好	
好ましさ	コノマシサ	好	
好まない	コノマナイ	嫌	
好み	コノミ	好	
好む	コノム	好	
困り切る	コマリキル	困	
困り抜く	コマリヌク	困	
困り果てる	コマリハテル	困	
困る	コマル	困	
小難しい	コムズカシイ	困	
小やかましい	コヤカマシイ	嫌	
こらぁ	コラァ	怒	
懲り懲り	コリゴリ	あ	
怖	コワ	怖	
怖い	コワイ	怖	
恐い	コワイ	怖	
怖がる	コワガル	怖	
怖怖	コワゴワ	怖	
恐恐	コワゴワ	怖	
怖さ	コワサ	怖	
強張る	コワバル	緊怖	
困却	コンキャク	困	
困窮	コンキュウ	困	
困苦	コンク	困苦	
困惑	コンワク	困	
合歓	ゴウカン	喜	
号泣	ゴウキュウ	悲	
号哭	ゴウコク	悲	
業腹	ゴウハラ	怒	
強欲	ゴウヨク	嫌	
業を煮やす	ゴウヲニヤス	怒	
御機嫌	ゴキゲン	喜楽	
ゴメン	ゴメン	謝	
最愛	サイアイ	好	
最悪	サイアク	Ｆ	
再燃	サイネン	気悩	
幸い	サイワイ	幸	
逆恨み	サカウラミ	恨	
蔑む	サゲスム	嫌	
差出がましい	サシデシガマシイ	恐	
殺気立つ	サッキタツ	興	
さっぱり	サッパリ	気	
さばさば	サバサバ	気	
寂しい	サビシイ	寂	
淋しい	サビシイ	寂	
淋しがる	サビシガル	寂	
淋しさ	サビシサ	寂	
寒気	サムケ	怖	
寒寒	サムザム	失	
さめざめ	サメザメ	悲	
冷める	サメル	失	
騒がしい	サワガシイ	嫌	
騒ぎ立つ	サワギタツ	嫌	
爽やか	サワヤカ	気	
鑽仰	サンギョウ	気	
讃嘆	サンタン	喜	
三拝九拝	サンパイキュウハイ	尊	
慚愧	ザンキ	恥	
残念	ザンネン	不	
幸せ	シアワセ	幸	
私怨	シエン	憎	
しおしお	シオシオ	悲	
しかめっ面	シカメッツラ	怒困Ｆ	
しかめる	シカメル	怒困Ｆ	
叱り付ける	シカリツケル	怒	
叱り飛ばす	シカリトバス	怒	
叱る	シカル	怒	
しくしく	シクシク	悲	
四苦八苦	シクハック	苦	
嗜好	シコウ	好	
至情	シジョウ	尊	
静まる	シズマル	穏	
沈み込む	シズミコム	失	
沈む	シズム	失	
慕い寄る	シタイヨル	好	
慕う	シタウ	好	
舌打ち	シタウチ	Ｆ	
親しみ	シタシミ	親	
親しむ	シタシム	親	
したり顔	シタリガオ	誇	
慕わしい	シタワシイ	親	
七面倒臭い	シチメンドウクサイ	Ｆ	
嫉視	シッシ	妬	
叱責	シッセキ	怒	
叱咤	シッタ	怒	
失墜感	シッツイカン	失	
嫉妬	シット	悔	
失意	シツイ	失	
しつこい	シツコイ	嫌	
失望	シツボウ	失	
失望感	シツボウカン	失	
失恋	シツレン	失	
忍び泣き	シノビナキ	悲	
忍び泣く	シノビナク	悲	
偲ぶ	シノブ	悲	
痺れる	シビレル	動	
私憤	シフン	怒	
渋る	シブル	た	
思慕	シボ	好	
湿っぽい	シメッポイ	Ｆ	
湿っぽさ	シメッポサ	Ｆ	
湿る	シメル	Ｆ	
謝意	シャイ	感	
癪	シャク	Ｆ	
癪に障る	シャクニサワル	Ｆ	
しゃくり上げる	シャクリアゲル	悲	
しゃくり泣き	シャクリナキ	悲	
醜悪	シュウアク	嫌	
秋思	シュウシ	寂	
愁思	シュウシ	悲	
愁傷	シュウショウ	悲	
周章	シュウショウ	焦	
周章狼狽	シュウショウロウバイ	焦	
愁色	シュウショク	鬱	
愁然	シュウゼン	鬱	
愁訴	シュウソ	苦悲	
愁嘆	シュウタン	悲	
羞恥	シュウチ	恥	
羞恥心	シュウチシン	恥	
祝着	シュウチャク	祝	
愁眉	シュウビ	心鬱	
愁眉を開く	シュウビヲヒラク	安穏	
秋風落莫	シュウフウラクバク	寂	
祝意	シュクイ	祝	
宿怨	シュクエン	恨	
祝賀	シュクガ	祝	
祝する	シュクスル	祝	
朱を注ぐ	シュヲソソグ	恥	
春愁	シュンシュウ	祝	
鍾愛	ショウアイ	好	
憧憬	ショウケイ	尊	
衝撃	ショウゲキ	驚	
悄悄	ショウショウ	失	
悄悄と	ショウショウト	失	
傷心	ショウシン	悲	
焦心	ショウシン	悲	
憔悴	ショウスイ	心憐	
悚然	ショウゼン	怖	
悄然	ショウゼン	不	
焦躁	ショウソウ	焦	
賞嘆	ショウタン	動	
悄沈	ショウチン	失	
焦慮	ショウリョ	焦	
性悪	ショウワル	嫌	
食指を動かす	ショクシオウゴカス	好	
食傷	ショクショウ	Ｆ	
悄気返る	ショゲカエル	失	
悄気る	ショゲル	失	
ショッキング	ショッキング	驚失	
ショック	ショック	驚失	
しょぼしょぼ	ショボショボ	失	
しょぼたれる	ショボタレル	失	
しょんぼり	ションボリ	失	
白ける	シラケル	あ	
しらける	シラケル	あ	
親愛	シンアイ	好親	
震撼	シンカン	驚怖	
心外	シンガイ	驚	
震駭	シンガイ	驚	
辛気臭い	シンキクサイ	焦怒	
呻吟	シンギン	苦	
辛苦	シンク	辛苦	
神経が張り詰める	シンケイガハリツメル	緊	
深謝	シンシャ	動	
心酔	シンスイ	好興	
親善	シンゼン	親	
心臓が止まる	シンゾウガトマル	驚	
心中穏やかでない	シンチュウオダヤカデナイ	心	
心痛	シンツウ	心	
しんどい	シンドイ	怠苦	
心配	シンパイ	心	
心服	シンプク	尊	
しんみり	シンミリ	寂	
心労	シンロウ	心悩	
辛労	シンロウ	辛苦	
慈愛	ジアイ	好	
じいんと	ジイント	動	
自棄	ジキ	嫌	
自虐	ジギャク	嫌	
忸怩	ジクジ	恥	
自己嫌悪	ジコケンオ	嫌	
自失	ジシツ	失	
ジジくさい	ジジクサイ	嫌	
自若	ジジャク	安穏	
自責	ジセキ	嫌	
地団太を踏む	ジダンダオフム	怒嫌	
自嘲	ジチョウ	嫌	
慈悲	ジヒ	憐	
自暴自棄	ジボウジキ	嫌	
自慢たらしい	ジマンタラシイ	嫌	
じめじめ	ジメジメ	Ｆ	
寂然	ジャクネン	寂	
雀躍	ジャクヤク	喜	
邪魔	ジャマ	嫌	
邪魔くさい	ジャマクサイ	嫌	
充実感	ジュウジツカン	気	
情	ジョウ	憐	
情愛	ジョウアイ	好	
情炎	ジョウエン	興	
上気	ジョウキ	怒	
上機嫌	ジョウキゲン	気	
情熱	ジョウネツ	興	
情欲	ジョウヨク	興	
焦らす	ジラス	焦	
じりじり	ジリジリ	焦	
焦れったい	ジレッタイ	焦Ｆ	
焦れったがる	ジレッタガル	焦Ｆ	
焦れったさ	ジレッタサ	焦Ｆ	
焦れる	ジレル	焦Ｆ	
仁愛	ジンアイ	好	
すうっと	スウット	気	
末恐ろしい	スエオソロシイ	ふ	
すえたのもしい	スエタノモシイ	尊	
好かない	スカナイ	嫌	
清々しい	スガスガシイ	気	
好き	スキ	好	
好き好む	スキコノム	好	
救われる	スクワレル	安	
すごすご	スゴスゴ	寂失	
荒む	スサム	嫌	
啜り上げる	ススリアゲル	悲	
啜り泣き	ススリナキ	悲	
啜り泣く	ススリナク	悲	
すっきり	スッキリ	気	
素っ頓狂	スットンキョウ	驚	
捨て台詞	ステゼリフ	情	
捨て鉢	ステバチ	嫌	
素晴らしい	スバラシイ	動	
すまん	スマン	謝	
随喜	ズイキ	喜	
図々しい	ズウズウシイ	嫌	
杜撰	ズサン	あ	
清清	セイセイ	気	
凄絶	セイゼツ	驚	
凄愴	セイソウ	悲	
青天の霹靂	セイテンノヘキレキ	気	
積怨	セキエン	恨	
急き込む	セキコム	焦	
寂莫	セキバク	寂	
寂莫感	セキバクカン	寂	
積憤	セキフン	怒	
赤面	セキメン	恥	
寂寥	セキリョウ	寂	
寂寥感	セキリョウカン	寂	
せこい	セコイ	嫌	
背筋が氷つく	セスジガコオリツク	怖	
背筋が凍る	セスジガコオル	怖	
世知辛い	セチツライ	辛	
切ない	セツナイ	切	
切ない思い	セツナイオモイ	切	
切なさ	セツナサ	切	
狭苦しい	セマクルシイ	Ｆ	
責め苦	セメク	苦	
戦意	センイ	緊	
戦々恐々	センセンキョウキョウ	怖	
センチメンタル	センチメンタル	悲	
羨望	センボウ	願	
旋毛を曲げる	センモウヲマゲル	嫌	
戦慄	センリツ	怖	
戦慄感	センリツカン	怖	
鮮烈	センレツ	驚	
絶句	ゼック	驚	
絶好調	ゼッコウチョウ	気	
絶体絶命	ゼッタイゼツメイ	怖焦	
絶頂感	ゼッチョウカン	気	
絶望	ゼツボウ	失	
粗悪	ソアク	見失	
壮快	ソウカイ	気	
爽快	ソウカイ	気	
総毛立つ	ソウケタツ	怖	
相好を崩す	ソウゴウヲクズス	喜	
相思相愛	ソウシソウアイ	好	
壮絶	ソウゼツ	驚	
騒々しい	ソウゾウシイ	嫌	
蒼白	ソウハク	怖	
爽涼	ソウリョウ	気	
惻隠	ソクイン	憐	
沮喪	ソソウ	失	
嫉み	ソネミ	妬	
嫉む	ソネム	妬	
空恐ろしい	ソラオソロシイ	怖	
空恐ろしさ	ソラオソロシサ	怖	
空空しい	ソラゾラシイ	あ	
空恥ずかしい	ソラハズカシイ	恥	
空喜び	ソラヨロコビ	喜	
そわそわ	ソワソワ	喜	
憎悪	ゾウオ	憎	
憎悪感	ゾウオカン	憎	
俗悪	ゾクアク	嫌見	
ぞくぞくする	ゾクゾクスル	興	
俗っぽい	ゾクッポイ	見	
ぞっこん	ゾッコン	興好	
ぞっとしない	ゾットシナイ	あ	
ぞっとする	ゾットスル	怖	
存外	ゾンガイ	驚	
大慶	タイケイ	喜	
大切	タイセツ	親	
泰然	タイゼン	安穏	
泰然自若	タイゼンジジャク	安穏	
大息	タイソク	あ	
怠惰	タイダ	怠	
高鳴る	タカナル	興	
高飛車	タカビシャ	嫌	
昂り	タカブリ	興	
昂	タカブリ	興	
昂ぶる	タカブル	興	
高笑い	タカワライ	喜気	
多岐亡羊	タキボウヨウ	悩	
たくましい	タクマシイ	尊	
猛り狂う	タケリクルウ	興	
猛り立つ	タケリタツ	興	
猛る	タケル	興	
多謝	タシャ	感	
たじたじ	タジタジ	困焦	
たじろぐ	タジログ	困焦	
助かりました	タスカリマシタ	感	
助かります	タスカリマス	感	
立ち竦む	タチスクム	怖	
愉しい	タノシイ	楽	
楽しい	タノシイ	楽	
楽しかった	タノシカッタ	楽	
楽しがる	タノシガル	楽	
楽しさ	タノシサ	楽	
楽しみ	タノシミ	楽	
楽しむ	タノシム	楽	
頼もしい	タノモシイ	尊親	
たまげる	タマゲル	驚	
魂を奪われたよう	タマシイヲウバワレタヨウ	失	
堪らない	タマラナイ	興嫌	
堪り兼ねる	タマリカネル	興嫌	
溜息	タメイキ	あ悩	
ため息をつく	タメイキヲツク	あ悩	
躊躇い	タメライ	悩	
躊躇う	タメラウ	悩	
揺蕩う	タユタウ	悩	
弛み	タユミ	安穏	
弛む	タユム	安穏	
頼り無い	タヨリナイ	失	
頼りなさ	タヨリナサ	失	
嘆賞	タンショウ	尊	
嘆じる	タンジル	失悲尊	
嘆ずる	タンズル	失悲尊	
嘆声	タンセイ	失悲	
嘆息	タンソク	失悲	
淡淡	タンタン	寂	
耽溺	タンデキ	興好	
嘆美	タンビ	尊	
大悦	ダイエツ	喜	
大嫌い	ダイキライ	嫌	
大事	ダイジ	驚	
大好き	ダイスキ	好	
惰気	ダキ	怠	
ダサい	ダサイ	嫌	
だらしない	ダラシナイ	嫌	
怠い	ダルイ	怠	
だるい	ダルイ	怠	
だれ気味	ダレキミ	怠	
だれる	ダレル	怠	
断腸の思い	ダンチョウノオモイ	残	
小さくなる	チイサクナル	恐	
力を落とす	チカラオオトス	失	
力落し	チカラオトシ	失	
力が抜ける	チカラガヌケル	失	
力付く	チカラズク	気	
力強い	チカラヅヨイ	気	
力抜け	チカラヌケ	失	
ちくちく	チクチク	ふ	
縮こまる	チジコマル	恐怖	
縮み上がる	チジミアガル	怖	
恥辱	チジョク	恥	
恥辱感	チジョクカン	恥	
血なまぐさい	チナマグサイ	Ｆ	
血の気が引く	チノケガヒク	怖	
血の涙	チノナミダ	辛悲	
血走る	チバシル	興	
血迷う	チマヨウ	怖怒	
チャーミング	チャーミング	喜	
躊躇	チュウチョ	た	
惆悵	チュウチョウ	悲恨	
中っ腹	チュウッパラ	Ｆ	
寵愛	チョウアイ	好	
弔意	チョウイ	悲	
悵然	チョウゼン	悲恨	
長嘆	チョウタン	悲	
沈鬱	チンウツ	鬱	
鎮静	チンセイ	安穏	
沈潜	チンセン	好興	
沈着	チンチャク	好興	
沈痛	チンツウ	悲鬱	
追悼	ツイトウ	悲	
追慕	ツイボ	悲切	
痛快	ツウカイ	気	
痛快さ	ツウカイサ	気	
痛快味	ツウカイミ	気	
痛哭	ツウコク	悲	
痛恨	ツウコン	残	
痛心	ツウシン	悲苦	
痛惜	ツウセキ	悲残悔	
痛嘆	ツウタン	悲	
痛憤	ツウフン	怒	
痛痒	ツウヨウ	苦	
閊えが下がる	ツカエガサガル	気	
閊えが取れる	ツカエガトレル	気	
つまらない	ツマラナイ	あＦ	
つまんない	ツマンナイ	あＦ	
冷たい	ツメタイ	Ｆ	
辛い	ツライ	辛	
辛さ	ツラサ	辛	
つれない	ツレナイ	嫌	
つんつん	ツンツン	嫌	
つんと	ツント	嫌	
涕泣	テイキュウ	悲	
啼泣	テイキュウ	悲	
諦念	テイネン	失	
涕涙	テイルイ	悲	
敵意	テキイ	嫌	
敵愾心	テキガイシン	興	
敵視	テキシ	嫌	
照れ隠し	テレカクシ	恥	
照れ臭い	テレクサイ	恥	
照れ臭さ	テレクササ	恥	
照れる	テレル	恥	
溺愛	デキアイ	好	
吐息	トイキ	安失	
陶酔	トウスイ	好	
陶然	トウゼン	好	
尊ぶ	トウトブ	尊	
当惑	トウワク	困	
ときめかす	トキメカス	興好	
ときめき	トキメキ	興好	
ときめく	トキメク	興好	
得意	トクイ	誇	
とげとげしい	トゲトゲシイ	嫌	
所得顏	トコロエガオ	誇	
妬心	トシン	妬	
飛び上がる	トビアガル	喜驚	
飛び退く	トビノク	驚怖	
途方に暮れる	トホウニクレル	失	
トホホ	トホホ	困	
戸惑い	トマドイ	困	
戸惑う	トマドウ	困	
取り越し苦労	トリコシクロウ	悩	
取り残される	トリノコサレル	寂	
鳥肌	トリハダ	怖驚	
取り乱す	トリミダス	焦	
とろい	トロイ	嫌	
蕩ける	トロケル	好	
怒	ド	怒	
動悸	ドウキ	緊	
同慶	ドウケイ	喜祝	
慟哭	ドウコク	悲	
瞠若	ドウジャク	驚	
同情	ドウジョウ	心	
動じる	ドウジル	困	
動顛	ドウテン	驚焦	
胴震い	ドウブルイ	興緊怖	
瞠目	ドウモク	驚尊	
動揺	ドウヨウ	怖緊	
怒気	ドキ	怒	
どきっ	ドキッ	驚怖願	
どきどき	ドキドキ	驚怖願	
どきり	ドキリ	驚怖願	
どきん	ドキン	驚怖願	
どぎつい	ドギツイ	Ｆ	
どぎまぎ	ドギマギ	焦	
度肝を抜かれる	ドギモヲヌカレル	驚	
怒号	ドゴウ	怒	
怒声	ドセイ	怒	
怒鳴り込む	ドナリコム	怒	
怒鳴り散らす	ドナリチラス	怒	
怒鳴り付ける	ドナリツケル	怒	
怒鳴る	ドナル	怒	
怒罵	ドバ	怒	
どよめく	ドヨメク	焦	
どんより	ドンヨリ	鬱	
萎え萎む	ナエシボム	鬱	
萎える	ナエル	失	
長たらしい	ナガタラシイ	あ嫌	
泣き	ナキ	悲	
泣き明かす	ナキアカス	悲	
泣き顔	ナキガオ	悲	
泣き崩れる	ナキクズレル	悲	
泣き暮らす	ナキクラス	悲	
泣き暮れる	ナキクレル	悲	
泣き込む	ナキコム	悲	
泣き声	ナキゴエ	悲	
泣き叫ぶ	ナキサケブ	悲	
泣き沈む	ナキシズム	悲	
泣きじゃくる	ナキジャクル	悲	
泣きたい	ナキタイ	悲	
泣き出す	ナキダス	悲	
泣き付く	ナキツク	悲	
泣き面	ナキツラ	悲	
泣き泣き	ナキナキ	悲	
泣き濡れる	ナキヌレル	悲	
泣き腫らす	ナキハラス	悲	
泣き伏す	ナキフス	悲	
泣き咽ぶ	ナキムセブ	悲	
泣き別れ	ナキワカレ	悲	
泣き別れる	ナキワカレル	悲	
泣く	ナク	悲	
泣く泣く	ナクナク	悲	
泣ける	ナケル	悲	
嘆かわしい	ナゲカワシイ	悲	
嘆き	ナゲキ	悲	
嘆き明かす	ナゲキアカス	悲	
嘆き悲しむ	ナゲキカナシム	悲	
嘆く	ナゲク	悲	
和やか	ナゴヤカ	安穏親	
名残惜しい	ナゴリオシイ	切	
名残惜しむ	ナゴリオシム	切	
情けない	ナサケナイ	情	
情けなさ	ナサケナサ	情	
馴染む	ナジム	安親	
懐かしい	ナツカシイ	安親	
懐かしがる	ナツカシガル	安親	
懐かしさ	ナツカシサ	安親	
懐かしみ	ナツカシミ	安親	
懐かしむ	ナツカシム	安親	
懐く	ナツク	安親	
生唾を呑む	ナマツバオノム	緊	
涙	ナミダ	悲	
涙雨	ナミダアメ	悲	
涙をのむ	ナミダオノム	悲	
涙が込み上げる	ナミダガコミアゲル	悲	
涙ぐましい	ナミダグマシイ	動	
涙ぐむ	ナミダグム	悲	
涙声	ナミダゴエ	悲	
波立つ	ナミダツ	怖緊	
涙に掻き暗れる	ナミダニカキクレル	悲	
涙に暮れる	ナミダニクレル	悲	
涙に咽ぶ	ナミダニムセブ	悲	
悩まされる	ナヤマサレル	悩	
悩ましい	ナヤマシイ	悩	
悩ます	ナヤマス	悩	
悩み	ナヤミ	悩	
悩む	ナヤム	悩	
馴れ馴れしい	ナレナレシイ	嫌	
難渋	ナンジュウ	困苦	
ナンセンス	ナンセンス	あ	
なんと	ナント	驚	
なんとまあ	ナントマア	驚	
煮え返る	ニエカエル	怒	
煮え繰り返る	ニエクリカエル	怒	
煮え立つ	ニエタツ	怒	
煮え湯を飲まされる	ニエユヲノマサレル	情悔	
苦い	ニガイ	Ｆ	
苦いものが込み上げる	ニガイモノガコミアゲル	興	
苦手	ニガテ	Ｆ	
苦々しい	ニガニガシイ	Ｆ	
苦り切る	ニガリキル	Ｆ	
苦る	ニガル	Ｆ	
苦笑い	ニガワライ	困	
憎い	ニクイ	憎	
憎く思う	ニククオモウ	憎	
憎しみ	ニクシミ	憎	
憎たらしい	ニクタラシイ	憎	
憎体	ニクテイ	憎	
憎々しい	ニクニクシイ	嫌	
憎む	ニクム	憎	
憎らしい	ニクラシイ	憎	
憎らしさ	ニクラシサ	憎	
にこにこ	ニコニコ	喜	
にこやか	ニコヤカ	喜	
にたにた	ニタニタ	喜嫌	
にっこり	ニッコリ	喜	
二の足を踏む	ニノアシオフム	た	
にやにや	ニヤニヤ	喜嫌	
にやり	ニヤリ	喜	
睨み付ける	ニラミツケル	嫌	
睨む	ニラム	嫌	
人情	ニンジョウ	安穏親	
にんまり	ニンマリ	喜	
糠喜び	ヌカヨロコビ	喜	
寝苦しい	ネグルシイ	不	
妬ましい	ネタマシイ	妬	
妬ましがる	ネタマシガル	妬	
妬み	ネタミ	妬	
妬み憎む	ネタミニクム	妬憎	
妬む	ネタム	妬	
ねちっこい	ネチッコイ	嫌	
熱愛	ネツアイ	好	
熱を上げる	ネツオアゲル	興好	
熱情	ネツジョウ	好	
熱に浮かされる	ネツニウカサレル	興好	
熱涙	ネツルイ	動	
悩殺	ノウサツ	悩	
悩乱	ノウラン	悩	
血の気が上る	ノケガノボル	怒	
残り多い	ノコリオオイ	残	
残り惜しい	ノコリオシイ	残	
ノスタルジア	ノスタルジア	親	
伸び伸び	ノビノビ	気	
逆上せ	ノボセ	誇嫌	
逆上せ上がる	ノボセアガル	誇嫌	
のめり込む	ノメリコム	興好	
呪い	ノロイ	憎恨	
呪う	ノロウ	憎恨	
呪わしい	ノロワシイ	憎恨	
暢気	ノンキ	安穏	
のんびり	ノンビリ	安穏	
儚い	ハカナイ	切	
図らずも	ハカラズモ	驚	
歯痒い	ハガユイ	悔	
剥れる	ハガレル	怒	
吐き気	ハキケ	Ｆ嫌苦	
吐気	ハキケ	Ｆ嫌苦	
歯軋り	ハギシリ	悔怒	
博愛	ハクアイ	好安穏	
激しい	ハゲシイ	興	
はしたない	ハシタナイ	嫌見	
燥ぐ	ハシャグ	気嫌	
恥	ハジ	恥	
恥じ入る	ハジイル	恥	
恥をかく	ハジオカク	恥	
恥じらい	ハジライ	恥	
恥じらう	ハジラウ	恥	
恥じる	ハジル	恥	
恥ずかしい	ハズカシイ	恥	
恥ずかしがる	ハズカシガル	恥	
恥ずかしさ	ハズカシサ	恥	
はた迷惑	ハタメイワク	嫌	
肌が粟立つ	ハダガアワダツ	怖	
肌に粟を生じる	ハダニアワヲショウジル	怖	
はっと	ハット	驚	
ハッピー	ハッピー	喜	
初恋	ハツコイ	好	
鼻白む	ハナジロム	Ｆあ	
鼻たかだか	ハナタカダカ	誇	
はにかむ	ハニカム	喜	
腹いせ	ハライセ	怒	
腹が立つ	ハラガタツ	怒	
腹黒い	ハラグロイ	嫌	
腹立たしい	ハラダタシイ	怒	
腹立たしさ	ハラダタシサ	怒	
腹立ち	ハラダチ	怒	
腹立つ	ハラダツ	怒	
腹に据え兼ねる	ハラニスエカネル	怒	
腹の虫が収まらない	ハラノムシガオサマラナイ	怒	
はらはら	ハラハラ	怖心	
腸が千切れる	ハラワタガチギレル	辛苦	
腸を抉られる	ハラワタヲエグラレル	辛苦	
腹を立てる	ハラヲタテル	怒	
張り合いが抜ける	ハリアイガヌケル	怠	
晴れがましい	ハレガマシイ	気	
晴れ晴れ	ハレバレ	気	
晴れ晴れしい	ハレバレシイ	気	
晴れやか	ハレヤカ	気	
反感	ハンカン	悔Ｆ	
反抗心	ハンコウシン	悔Ｆ	
煩悶	ハンモン	苦悩	
煩労	ハンロウ	苦悩	
ばかくさい	バカクサイ	あ嫌	
ばかばかしい	バカバカシイ	あ嫌	
バカヤロー	バカヤロ?	嫌	
馬鹿らしい	バカラシイ	あ嫌	
ばっちい	バッチイ	嫌	
ばつが悪い	バツガワルイ	き	
万歳	バンザイ	祝喜	
悲哀	ヒアイ	悲憐	
悲哀感	ヒアイカン	悲憐	
贔屓	ヒイキ	親	
ひいひい	ヒイヒイ	辛	
冷え切る	ヒエキル	寂	
冷え冷え	ヒエビエ	寂	
冷える	ヒエル	寂	
悲観	ヒカン	心	
僻み	ヒガミ	妬	
僻む	ヒガム	Ｆ妬	
悲泣	ヒキュウ	悲	
卑怯	ヒキョウ	嫌見	
悲惨	ヒサン	憐	
悲秋	ヒシュウ	悲	
悲愁	ヒシュウ	悲	
悲傷	ヒショウ	悲	
悲壮	ヒソウ	悲尊	
悲愴	ヒソウ	悲	
顰み	ヒソミ	怒困	
卑俗	ヒゾク	あ見嫌	
悲嘆	ヒタン	悲	
悲痛	ヒツウ	悲辛苦	
一安心	ヒトアンシン	安穏	
人恋しい	ヒトコイシイ	切	
人懐こい	ヒトナツコイ	親	
ひとりぼっち	ヒトリボッチ	寂	
酷い	ヒドイ	憐悲怒	
悲風	ヒフウ	悲	
悲憤	ヒフン	悲怒	
悲鳴	ヒメイ	悲驚怖	
冷や汗	ヒヤアセ	恥怖緊	
ひやっ	ヒヤッ	驚怖緊	
冷や冷や	ヒヤヒヤ	驚怖緊	
ひやり	ヒヤリ	驚怖緊	
拍子抜け	ヒョウシヌケ	あ失	
表情を強張らせる	ヒョウジョウヲコワバラセル	緊	
開いた口が塞がらない	ヒライタクチガフサガラナイ	あ	
悲涙	ヒルイ	悲	
怯む	ヒルム	怖驚緊	
卑劣	ヒレツ	嫌見	
悲恋	ヒレン	悲切	
卑猥	ヒワイ	嫌	
顰蹙	ヒンシュク	怒困	
びくっ	ビクッ	驚怖	
びくつく	ビクツク	驚怖	
びくびく	ビクビク	驚怖	
びくり	ビクリ	驚怖	
微笑	ビショウ	喜	
吃驚	ビックリ	驚	
吃驚仰天	ビックリギョウテン	驚	
憫察	ビンサツ	心尊	
ぴくぴく	ピクピク	緊怖	
ぴりぴり	ピリピリ	緊	
不安	フアン	ふ	
不安がる	フアンガル	ふ	
不安定	フアンテイ	怖	
不快	フカイ	Ｆ	
不快感	フカイカン	Ｆ	
不快さ	フカイサ	Ｆ	
腑甲斐無い	フガイナイ	情	
不機嫌	フキゲン	嫌	
不気味	フキミ	怖	
不気味さ	フキミサ	怖	
不興	フキョウ	あ	
不謹慎	フキンシン	嫌	
膨れっ面	フクレッツラ	怒	
不潔	フケツ	嫌見	
耽る	フケル	興好	
不幸	フコウ	悲憐	
鬱ぎ込む	フサギコム	鬱	
鬱ぐ	フサグ	鬱	
伏し目	フシメ	悩	
不承不承	フショウブショウ	た	
父性愛	フセイアイ	好	
吹っ切れる	フッキレル	気	
怫然	フツゼン	怒	
ふてぶてしい	フテブテシイ	嫌	
腑抜け	フヌケ	見	
不憫	フビン	憐	
不憫さ	フビンサ	憐	
不服	フフク	不	
不平	フヘイ	不	
不本意	フホンイ	不	
不満	フマン	不	
不満足	フマンゾク	不	
不味	フミ	Ｆ	
不面目	フメンボク	Ｆ	
不愉快	フユカイ	Ｆ	
不愉快感	フユカイカン	Ｆ	
不愉快さ	フユカイサ	Ｆ	
ふらち	フラチ	嫌	
ふらふら	フラフラ	緊	
不慮	フリョ	驚悲憐	
奮い起こす	フルイオコス	興	
奮い立つ	フルイタツ	興	
震い付く	フルイツク	興	
震う	フルウ	怖	
震え上がる	フルエアガル	怖	
震え戦く	フルエオノノク	怖	
震えが来る	フルエガクル	怖	
震え出す	フルエダス	怖	
震える	フルエル	緊怖	
憤慨	フンガイ	怒	
奮起	フンキ	興	
憤激	フンゲキ	怒	
憤死	フンシ	怒	
憤然	フンゼン	怒	
奮然	フンゼン	興	
憤怒	フンヌ	怒	
憤懣	フンマン	怒	
ぶうぶう	ブウブウ	不	
不格好	ブカッコウ	嫌	
無様	ブザマ	見	
憮然	ブゼン	不	
物騒	ブッソウ	怖	
仏頂面	ブッチョウズラ	Ｆ	
ぶつくさ	ブツクサ	不	
ぶるぶる	ブルブル	怖	
無礼	ブレイ	嫌	
ぷいと	プイト	Ｆ	
ぷりぷり	プリプリ	怒	
ぷんぷん	プンプン	怒	
平安	ヘイアン	安穏	
平穏	ヘイオン	安穏	
平気	ヘイキ	安穏	
閉口	ヘイコウ	困悩	
平静	ヘイセイ	穏	
平然	ヘイゼン	穏	
へいちゃら	ヘイチャラ	穏	
辟易	ヘキエキ	Ｆ	
臍を曲げる	ヘソヲマゲル	Ｆ	
下手糞	ヘタクソ	嫌	
下手の横好き	ヘタノヨコズキ	嫌	
反吐	ヘド	嫌	
へどもど	ヘドモド	困焦	
偏愛	ヘンアイ	好	
べそをかく	ベソヲカク	悲	
法悦	ホウエツ	喜	
頬が火照る	ホウガホテル	恥	
放心	ホウシン	あ	
放心状態	ホウシンジョウタイ	あ	
法楽	ホウラク	喜	
頬を染める	ホウヲソメル	恥	
朗か	ホガラカ	喜	
北叟笑む	ホクソエム	喜	
ほくほく	ホクホク	喜	
誇らしい	ホコラシイ	誇	
誇らしさ	ホコラシサ	誇	
誇り	ホコリ	誇	
誇る	ホコル	誇	
綻ばす	ホコロバス	喜	
綻びる	ホコロビル	喜	
綻ぶ	ホコロブ	喜	
ほっと	ホット	安穏	
火照る	ホテル	恥	
仄仄	ホノボノ	安穏親	
微笑み	ホホエミ	喜	
微笑む	ホホエム	楽面	
頬を染める	ホホヲソメル	恥	
褒めそやす	ホメソヤス	喜	
褒め讃える	ホメタタエル	祝	
褒めちぎる	ホメチギル	祝	
褒める	ホメル	祝	
惚れ込む	ホレコム	好	
惚れ惚れ	ホレボレ	好	
惚れる	ホレル	好	
ほろっと	ホロット	悲	
ほろ苦い	ホロニガイ	Ｆ	
ほろほろ	ホロホロ	悲	
ほろり	ホロリ	悲	
望外	ボウガイ	驚	
呆然	ボウゼン	あ	
惘然	ボウゼン	あ	
茫然	ボウゼン	あ	
暴慢	ボウマン	嫌	
亡羊の嘆	ボウヨウノタン	悩	
慕情	ボジョウ	親	
母性愛	ボセイアイ	好	
勃然	ボツゼン	驚	
ぼろぼろ	ボロボロ	悲	
ぼんやりする	ボンヤリスル	あ	
ぼうっとなる	ボーットナル	あ	
ぽうっとなる	ポウットナル	あ	
ぽかんとする	ポカントスル	あ	
ぽろぽろ	ポロポロ	悲	
ぽろり	ポロリ	悲	
まがまがしい	マガマガシイ	怖	
間が悪い	マガワルイ	き	
負け惜しみ	マケオシミ	悔	
まごつく	マゴツク	悩	
まごまご	マゴマゴ	悩	
まさかの	マサカノ	驚	
不味い	マズイ	Ｆ	
貧しい	マズシイ	見嫌	
まだるっこい	マダルッコイ	Ｆ	
待ち焦がれる	マチコガレル	願	
待ち遠しい	マチドウシイ	願	
真っ暗	マックラ	怖	
真っ青	マッサオ	怖	
真っ平	マッピラ	あＦ	
惑い	マドイ	困	
惑う	マドウ	困	
惑わす	マドワス	困	
眩しい	マブシイ	尊	
眉が晴れる	マユガハレル	気	
眉根を顰める	マユネオシカメル	困怒	
眉を曇らす	マユヲクモラス	心困	
眉を顰める	マユヲシカメル	困怒	
眉を開く	マユヲヒラク	気安穏	
迷い	マヨイ	悩	
迷う	マヨウ	悩	
回りくどい	マワリクドイ	不	
満悦	マンエツ	喜	
満更でもない	マンザラデモナイ	喜	
満足	マンゾク	気	
満足感	マンゾクカン	気	
満面朱を注ぐ	マンメンシュヲソソグ	恥怒	
見上げる	ミアゲル	尊	
身勝手	ミガッテ	嫌	
見下す	ミクダス	見	
見縊る	ミクビル	見	
見苦しい	ミグルシイ	嫌	
見事	ミゴト	尊	
見下げる	ミサゲル	見	
惨め	ミジメ	憐	
惨めさ	ミジメサ	憐	
みすぼらしい	ミスボラシイ	憐	
見づらい	ミズライ	不	
見染める	ミソメル	好	
満たされる	ミタサレル	気	
乱れる	ミダレル	興	
満ち足りる	ミチタリル	気	
みっともない	ミットモナイ	嫌見	
みっともよくない	ミットモヨクナイ	嫌見	
見惚れる	ミトレル	好	
醜い	ミニクイ	嫌	
見憎い	ミニクイ	嫌	
身の毛が弥立つ	ミノケガヨダツ	怖	
身震いがする	ミブルイガスル	怖	
みみっちい	ミミッチイ	嫌見	
身悶え	ミモダエ	苦	
身悶える	ミモダエル	苦	
身も縮む	ミモチジム	怖	
未練	ミレン	悔	
未練がましい	ミレンガマシイ	悔	
身を切られる	ミヲキラレル	苦	
身を裂く	ミヲサク	苦	
むかっと	ムカット	怒	
向っ腹	ムカッパラ	怒	
向っ腹が立つ	ムカッパラガタツ	怒	
向っ腹を立てる	ムカッパラヲタテル	怒	
むかつく	ムカツク	怒	
むかむか	ムカムカ	怒	
無我夢中	ムガムチュウ	好興	
向きになる	ムキニナル	怒	
無気力	ムキリョク	怠	
惨たらしい	ムゴタラシイ	憐怖	
むさい	ムサイ	嫌	
むさくるしい	ムサクルシイ	嫌	
蒸し暑い	ムシアツイ	Ｆ	
虫酸が走る	ムシズガハシル	嫌	
むしゃくしゃ	ムシャクシャ	怒興	
むずかる	ムズカル	怒	
むず痒い	ムズガユイ	Ｆ	
むずむず	ムズムズ	嫌	
咽び泣き	ムセビナキ	悲	
咽び泣く	ムセビナク	悲	
咽ぶ	ムセブ	悲	
噎せる	ムセル	Ｆ	
夢中になる	ムチュウニナル	興好	
むっと	ムット	怒	
むつまじい	ムツマジイ	親好	
胸糞が悪い	ムナクソガワルイ	嫌	
胸苦しい	ムナグルシイ	辛苦	
胸騒ぎ	ムナサワギ	心	
空しい	ムナシイ	失	
虚しい	ムナシイ	失	
虚しさ	ムナシサ	失	
胸躍る	ムネオドル	興好	
胸を撫で下ろす	ムネオナデオロス	安穏	
胸が熱くなる	ムネガアツクナル	興	
胸が痛くなる	ムネガイタクナル	悲	
胸が一杯になる	ムネガイッパイニナル	興	
胸がすく	ムネガスク	気	
胸が潰れる	ムネガツブレル	悲	
胸が詰まる	ムネガツマル	切	
胸が轟く	ムネガトドロク	興	
胸が弾む	ムネガハズム	興喜	
胸が早鐘を打つ	ムネガハヤガネヲウツ	興	
胸が張り裂ける	ムネガハリサケル	苦	
胸が塞がる	ムネガフサガル	苦	
胸が震える	ムネガフルエル	怖緊	
胸が悪い	ムネガワルイ	Ｆ怒	
胸につかえる	ムネニツカエル	Ｆ	
胸を痛める	ムネヲイタメル	辛苦	
胸を打たれる	ムネヲウタレル	動	
胸を抉られる	ムネヲエグラレル	辛苦	
胸を躍らせる	ムネヲオドラセル	喜興	
胸を焦がす	ムネヲコガス	興好	
胸を締め付けられる	ムネヲシメツケラレル	辛苦	
胸を締められる	ムネヲシメラレル	辛苦	
胸を突かれる	ムネヲツカレル	驚	
胸を膨らませる	ムネヲフクラマセル	興	
無念	ムネン	残	
無念さ	ムネンサ	残	
無念遣る方ない	ムネンヤルカタナイ	残	
むらむら	ムラムラ	興	
滅入り込む	メイリコム	鬱	
滅入る	メイル	鬱	
迷惑	メイワク	嫌	
目が潤む	メガウルム	動悲	
目頭が熱くなる	メガシラガアツクナル	動	
目障り	メザワリ	嫌	
目尻を下げる	メジリヲサゲル	喜	
めずらしい	メズラシイ	驚	
めそめそ	メソメソ	悲	
めでたい	メデタイ	祝	
目に角を立てる	メニカドヲタテル	怒	
眩暈	メマイ	Ｆ	
女々しい	メメシイ	嫌	
メロメロ	メロメロ	好	
目を白黒させる	メヲシロクロサセル	苦	
目をパチクリさせる	メヲパチクリサセル	驚	
眼を伏せる	メヲフセル	たＦ	
目を細める	メヲホソメル	喜	
目を丸くする	メヲマルクスル	驚	
目を瞠る	メヲミハル	興	
目を剥く	メヲムク	怒	
面食らう	メンクラウ	驚	
面倒い	メンドイ	怠	
面倒	メンドウ	怠	
面倒臭い	メンドウクサイ	怠	
面目無い	メンボクナイ	恥	
盲愛	モウアイ	好	
申し分ない	モウシブンナイ	尊	
申し訳ない	モウシワケナイ	恐	
燃え尽きる	モエツキル	失	
もじもじする	モジモジスル	ふ恥	
悶え	モダエ	苦悩	
悶える	モダエル	苦悩	
もどかしい	モドカシイ	情悩	
もどかしがる	モドカシガル	情悩	
もどかしさ	モドカシサ	情悩	
物哀れ	モノアワレ	憐	
物憂い	モノウイ	鬱	
懶い	モノウイ	怠	
懶さ	モノウサ	怠	
物怖じ	モノオジ	怖	
物恐ろしい	モノオソロシイ	怖	
物思い	モノオモイ	鬱	
物悲しい	モノガナシイ	悲	
物悲しさ	モノガナシサ	悲	
物淋しい	モノサビシイ	切寂	
物寂しい	モノサビシイ	切寂	
物騒がしい	モノサワガシイ	嫌	
物足りない	モノタリナイ	不	
物足りなさ	モノタリナサ	不	
貰い泣き	モライナキ	悲	
文句を言う	モンクヲイウ	不	
悶絶	モンゼツ	悩苦	
悶悶	モンモン	悩苦	
喧しい	ヤカマシイ	嫌	
やきもき	ヤキモキ	嫌Ｆ	
焼き餅を焼く	ヤキモチヲヤク	妬	
妬く	ヤク	妬	
自棄糞	ヤケクソ	あ嫌	
灼け爛れる	ヤケタダレル	辛苦	
妬ける	ヤケル	妬	
灼ける	ヤケル	苦	
安らか	ヤスラカ	安穏	
安らかさ	ヤスラカサ	安穏	
安らぎ	ヤスラギ	安穏	
安らぐ	ヤスラグ	安穏	
ヤダー	ヤダー	嫌	
やっかい	ヤッカイ	嫌	
やっかみ	ヤッカミ	嫌	
やっかむ	ヤッカム	嫌	
躍起	ヤッキ	興	
ヤッター	ヤッター	喜	
八つ当たり	ヤツアタリ	不怒	
破れかぶれ	ヤブレカブレ	嫌	
野暮ったい	ヤボッタイ	嫌	
疚しい	ヤマシイ	恥嫌	
やむ無い	ヤムナイ	残	
やむを得ない	ヤムヲエナイ	残	
ややこしい	ヤヤコシイ	Ｆ	
遣り切れない	ヤリキレナイ	悔	
遣る瀬ない	ヤルセナイ	悲	
遣る瀬なさ	ヤルセナサ	悲	
やれやれ	ヤレヤレ	あ	
友愛	ユウアイ	好	
憂鬱	ユウウツ	鬱	
憂鬱感	ユウウツカン	鬱	
憂患	ユウカン	心悩	
友誼	ユウギ	好	
憂苦	ユウク	鬱苦	
友好	ユウコウ	好	
憂国	ユウコク	鬱	
憂思	ユウシ	鬱	
憂愁	ユウシュウ	鬱	
幽愁	ユウシュウ	鬱	
憂色	ユウショク	鬱心	
憂心	ユウシン	鬱心	
友情	ユウジョウ	好	
悠然	ユウゼン	穏	
悠長	ユウチョウ	穏	
憂憤	ユウフン	鬱怒	
憂悶	ユウモン	心悩	
勇躍	ユウヤク	興	
悠悠	ユウユウ	穏	
悠悠閑閑	ユウユウカンカン	穏	
悠揚	ユウヨウ	穏	
憂慮	ユウリョ	心ふ	
愉悦	ユエツ	喜	
愉快	ユカイ	喜	
揺さ振る	ユサブル	驚怖	
揺す振る	ユスブル	驚怖	
愉楽	ユラク	喜	
揺らぐ	ユラグ	驚怖悩	
揺らめく	ユラメク	悩	
ゆらゆら	ユラユラ	穏	
ゆらり	ユラリ	穏	
揺るがす	ユルガス	驚怖	
揺るがない	ユルガナイ	安穏	
揺るぎ無い	ユルギナイ	安穏	
揺るぐ	ユルグ	驚怖	
揺れ	ユレ	驚怖	
揺れる	ユレル	驚怖	
好い感情を持つ	ヨイカンジョウヲモツ	好	
好い気持ちがしない	ヨイキモチガシナイ	Ｆ	
好い気持ちはしない	ヨイキモチハシナイ	Ｆ	
好い心持ち	ヨイココロモチ	好	
好い心持ちはしない	ヨイココロモチワシナイ	Ｆ	
酔う	ヨウ	興	
良かった	ヨカッタ	安穏	
好く	ヨク	好	
抑鬱	ヨクウツ	Ｆ鬱	
欲情	ヨクジョウ	興	
邪	ヨコシマ	嫌	
横恋慕	ヨコレンボ	好	
慶福	ヨシトミ	喜幸	
好	ヨシミ	好	
よっしゃ	ヨッシャ	喜	
余憤	ヨフン	怒	
喜ばしい	ヨロコバシイ	喜	
喜ばしい訳はない	ヨロコバシイワケワナイ	失	
喜ばしさ	ヨロコバシサ	喜	
喜	ヨロコビ	喜	
喜び	ヨロコビ	喜	
喜び狂う	ヨロコビクルウ	喜	
喜ぶ	ヨロコブ	喜	
弱り切る	ヨワリキル	失	
弱り果てる	ヨワリハテル	失	
弱る	ヨワル	失	
楽	ラク	楽	
落胆	ラクタン	失	
楽ちん	ラクチン	楽	
落莫	ラクバク	寂	
楽楽	ラクラク	楽	
落涙	ラクルイ	悲	
ラッキー	ラッキー	喜	
理屈っぽい	リクツッポイ	嫌	
離愁	リシュウ	悲寂	
立腹	リップク	怒	
慄然	リツゼン	怖	
溜飲が下がる	リュウインガサガル	気	
良好	リョウコウ	好	
良心が痛む	リョウシンガイタム	Ｆた	
慮外	リョガイ	驚	
旅愁	リョシュウ	鬱	
ルンルン	ルンルン	気	
冷静	レイセイ	緊	
恋愛	レンアイ	好	
恋情	レンジョウ	好	
廉恥	レンチ	恥	
憐憫	レンビン	親憐	
恋慕	レンボ	好	
恋恋	レンレン	好た	
労苦	ロウク	苦	
狼狽	ロウバイ	焦	
我がまま	ワガママ	嫌	
沸き返る	ワキカエル	興	
沸き立つ	ワキタツ	興	
惑溺	ワクデキ	興	
惑乱	ワクラン	興	
わくわく	ワクワク	喜興	
煩い	ワズライ	悩	
煩う	ワズラウ	悩	
煩わしい	ワズラワシイ	嫌悩	
煩わす	ワズラワス	悩	
蟠り	ワダカマリ	不	
蟠る	ワダカマル	不	
わっ	ワッ	驚	
戦慄き	ワナナキ	怖	
戦慄く	ワナナク	怖	
わなわな	ワナワナ	怖	
詫びしい	ワビシイ	切寂	
佗びしい	ワビシイ	切寂	
佗びしがる	ワビシガル	切寂	
佗びしさ	ワビシサ	切寂	
詫びる	ワビル	切寂	
笑い	ワライ	喜	
笑い顔	ワライガオ	喜	
笑う	ワラウ	喜	
悪い	ワルイ	嫌	
悪い気がしない	ワルイキガシナイ	気	
悪賢い	ワルガシコイ	嫌	
悪びれる	ワルビレル	謝	
我を忘れる	ワレオワスレル	興	
わぁ	ワー	喜	
わーい	ワーイ	喜	
			
			
			
			
			
			
			
			
			
			
			
			
			
			
			
			
			
			
			
