Word	Katakana	Emotion	
哀	アイ	悲	
愛	アイ	好親安尊	
相いれない	アイイレナイ	不	
哀感	アイカン	悲	
愛敬	アイキョウ	親	
愛好	アイコウ	好親	
哀愁	アイシュウ	悲	
愛執	アイシュウ	好	
哀傷	アイショウ	悲失痛	
愛情	アイジョウ	好親	
愛する	アイスル	好親	
哀惜	アイセキ	悲	
哀切	アイセツ	悲	
愛想を尽かす	アイソオツカス	嫌	
愛着	アイチャク	好親	
哀悼	アイトウ	悲	
愛慕	アイボ	好尊親安	
愛欲	アイヨク	好	
愛らしい	アイラシイ	好	
青息吐息	アオイキトイキ	ふ辛心	
仰ぐ	アオグ	尊	
青筋を立てる	アオスジヲタテル	怒興	
赤恥	アカッパジ	恥	
赤らむ	アカラム	恥	
赤らめる	アカラメル	恥	
崇める	アガメル	尊	
飽き飽き	アキアキ	不	
飽き足りる	アキタリル	幸	
諦め	アキラメ	悔情残	
諦める	アキラメル	悔情残	
飽きる	アキル	不	
呆れ返る	アキレカエル	あ	
呆れ果てる	アキレハテル	あ	
呆れる	アキレル	あ	
悪感情	アクカンジョウ	嫌	
倦む	アグム	悩鬱	
憧れ	アコガレ	尊親	
憧れる	アコガレル	尊親	
浅ましい	アサマシイ	あ憐見	
嘲る	アザケル	見	
味気ない	アジケナイ	不	
焦り	アセリ	焦	
焦る	アセル	焦	
唖然	アゼン	驚	
頭に来る	アタマニクル	怒	
頭を悩ませる	アタマヲナヤマセル	悩	
当たり散らす	アタリチラス	怒	
あッ	アッ	驚	
あっけない	アッケナイ	不	
呆気に取られる	アッケニトラレル	驚	
圧迫感	アッパクカン	苦	
熱い	アツイ	興不	
熱いものがこみ上げる	アツイモノガコミアゲル	興	
厚かましい	アツカマシイ	不	
熱くなる	アツクナル	興	
暑苦しい	アツクルシイ	不	
後味が良くない	アトアジガヨクナイ	不	
後味が宜しくない	アトアジガヨロシクナイ	不	
後味が悪い	アトアジガワルイ	不	
侮る	アナドル	見	
阿鼻叫喚	アビキョウカン	辛苦	
危ない	アブナイ	ふ	
あほらしい	アホラシイ	あ見	
荒々しい	アラアラシイ	不	
あらッ	アラッ	驚	
ありがたい	アリガタイ	感	
ありがたみ	アリガタミ	感	
ありがた迷惑	アリガタメイワク	不	
ありがと	アリガト	感	
ありがとう	アリガトウ	感	
ありゃ	アリャ	驚	
慌てふためく	アワテフタメク	焦	
慌てる	アワテル	焦	
哀れ	アワレ	憐	
憐れ	アワレ	憐	
憐れみ	アワレミ	憐	
憐れむ	アワレム	憐	
安逸	アンイツ	安楽	
暗鬱	アンウツ	鬱	
安閑	アンカン	安穏	
案外	アンガイ	驚不	
安心	アンシン	安穏	
案ずる	アンズル	心	
暗然	アンゼン	悲鬱	
安息感	アンソクカン	安	
暗澹	アンタン	ふ鬱	
安定	アンテイ	穏	
安堵	アンド	安穏	
安寧	アンネイ	安穏	
安楽	アンラク	安穏	
怡怡	イイ	喜楽	
言い寄る	イイヨル	不好	
いかがわしい	イカガワシイ	不	
厳つい	イカツイ	不	
怒らす	イカラス	怒	
怒り	イカリ	怒	
怒りが爆発する	イカリガバクハツスル	怒興	
怒り狂う	イカリクルウ	怒	
遺憾	イカン	残	
意外	イガイ	驚	
啀み合う	イガミアウ	見怒	
啀む	イガム	怒	
息を詰める	イキオツメル	ふ	
息が詰まる	イキガツマル	不	
息苦しい	イキグルシイ	苦不	
息苦しさ	イキグルシサ	苦不	
意気軒昂	イキケンコウ	興	
意気消沈	イキショウチン	鬱	
憤り	イキドオリ	怒	
憤る	イキドオル	怒	
行き悩む	イキナヤム	悩	
生き恥	イキハジ	恥	
息巻く	イキマク	怒	
熱り立つ	イキリタツ	怒興	
息を飲む	イキヲノム	驚怖	
息を潜める	イキヲヒソメル	緊	
いけ好かない	イケスカナイ	不嫌	
いけ図々しい	イケズウズウシイ	不嫌	
依怙地になる	イコジニナル	怒	
遺恨	イコン	恨残	
勇ましい	イサマシイ	興	
意趣	イシュ	恨	
萎縮	イシュク	ふ心	
意地汚い	イジキタナイ	不嫌	
意地悪	イジワル	不嫌	
いそいそ	イソイソ	喜	
意想外	イソウガイ	驚	
痛い	イタイ	辛苦	
痛々しい	イタイタシイ	憐	
居た堪れない	イタタマレナイ	不	
痛ましい	イタマシイ	憐	
痛み	イタミ	辛苦	
痛み入る	イタミイル	恐感	
悼む	イタム	悲	
痛める	イタメル	辛苦	
いちゃもんを付ける	イチャモンヲツケル	不怒	
一憂	イチユウ	鬱	
一喜	イッキ	喜	
一驚	イッキョウ	驚	
慈しみ	イツクシミ	親	
慈しむ	イツクシム	親	
逸楽	イツラク	楽	
厭う	イトウ	嫌	
愛おしい	イトオシイ	好親安	
愛おしむ	イトオシム	好親安	
愛しい	イトシイ	好親安	
愛しがる	イトシガル	好親安	
愛しさ	イトシサ	好親安	
厭わしい	イトワシイ	嫌	
厭わしさ	イトワシサ	嫌	
畏怖	イフ	怖	
忌忌しい	イマイマシイ	嫌恐	
忌忌しがる	イマイマシガル	嫌	
忌まわしい	イマワシイ	嫌	
忌み嫌う	イミキラウ	嫌	
忌む	イム	嫌	
嫌	イヤ	嫌	
厭	イヤ	嫌	
厭厭	イヤイヤ	嫌不	
厭がる	イヤガル	嫌	
嫌気	イヤケ	嫌	
卑しい	イヤシイ	見	
卑しむ	イヤシム	見	
嫌味	イヤミ	嫌	
厭らしい	イヤラシイ	不嫌	
苛苛しい	イライラシイ	怒	
苛苛する	イライラスル	怒	
苛立たしい	イラダタシイ	怒	
苛立たしさ	イラダタシサ	怒	
苛立ち	イラダチ	怒	
苛立つ	イラダツ	怒	
苛立てる	イラダテル	怒	
色を失う	イロヲウシナウ	心怖	
色をなす	イロヲナス	怒	
陰鬱	インウツ	鬱	
陰気	インキ	鬱	
陰気臭い	インキクサイ	不嫌	
陰惨	インサン	憐	
陰湿	インシツ	不嫌	
浮かされる	ウカサレル	苦辛好	
浮かぬ顔	ウカヌカオ	悩鬱	
浮かれる	ウカレル	楽興	
浮き足立つ	ウキアシタツ	ふ心	
うきうきする	ウキウキスル	楽興喜	
浮き立つ	ウキタツ	楽興ふ焦	
憂き目	ウキメ	辛悲	
憂さ	ウサ	鬱	
胡散臭い	ウサンクサイ	不	
後ろめたい	ウシロメタイ	ふ焦	
後ろめたさ	ウシロメタサ	ふ焦	
薄気味悪い	ウスキミワルイ	不	
薄汚い	ウスギタナイ	不	
うずうず	ウズウズ	興	
打ち萎れる	ウチシオレル	残	
打ち拉がれる	ウチヒシガレル	残	
有頂天	ウチョウテン	誇	
鬱気	ウッキ	鬱	
鬱屈	ウックツ	鬱	
鬱散	ウッサン	鬱	
鬱積	ウッセキ	鬱	
鬱陶しい	ウットウシイ	不嫌	
鬱陶しさ	ウットウシサ	不嫌	
うっとり	ウットリ	好安	
鬱憤	ウップン	怒恨不	
鬱	ウツ	鬱	
鬱鬱と	ウツウツト	鬱	
俯き	ウツムキ	鬱悩辛苦ふ	
俯く	ウツムク	鬱悩辛苦ふ	
鬱悶	ウツモン	悩苦辛鬱ふ	
虚	ウツロ	鬱	
疎ましい	ウトマシイ	嫌	
疎む	ウトム	嫌	
疎んじる	ウトンジル	嫌	
疎んずる	ウトンズル	嫌	
美味い	ウマイ	幸	
旨い	ウマイ	幸	
上手い	ウマイ	動	
呻き声	ウメキゴエ	苦	
呻く	ウメク	苦	
敬う	ウヤマウ	尊	
うら悲しい	ウラガナシイ	悲	
うら淋しい	ウラサビシイ	寂	
うら寂しい	ウラサビシイ	寂	
恨み	ウラミ	恨	
恨みがましい	ウラミガマシイ	恨	
恨む	ウラム	恨	
恨めしい	ウラメシイ	恨憎残情	
恨めしがる	ウラメシガル	恨憎残情	
恨めしく思う	ウラメシクオモウ	恨憎残情	
羨ましい	ウラヤマシイ	不妬	
羨ましがる	ウラヤマシガル	不妬	
羨む	ウラヤム	不妬	
五月蝿い	ウルサイ	不怒	
麗しい	ウルワシイ	好	
憂い	ウレイ	悲辛苦	
愁い	ウレイ	心悲	
愁え	ウレイ	心悲	
憂える	ウレエル	心	
嬉しい	ウレシイ	喜	
嬉しかった	ウレシカッタ	喜	
嬉しがらせ	ウレシガラセ	喜	
嬉しがらせる	ウレシガラセル	喜	
嬉しがる	ウレシガル	喜	
嬉しさ	ウレシサ	喜	
嬉し泣き	ウレシナキ	喜	
嬉し涙	ウレシナミダ	喜	
嬉しみ	ウレシミ	喜	
憂わしい	ウレワシイ	憐	
狼狽える	ウロタエル	驚焦	
上擦る	ウワズル	興怒	
うんざり	ウンザリ	不嫌	
詠嘆	エイタン	動	
笑顔	エガオ	幸安	
依怙贔屓	エコヒイキ	不嫌	
えッ	エッ	驚	
悦	エツ	喜	
笑壺に入る	エツボニハイル	喜	
悦楽	エツラク	喜楽	
恵比寿顔	エビスガオ	喜楽安	
笑み	エミ	幸安	
笑む	エム	幸安	
厭悪	エンオ	嫌恨不	
怨恨	エンコン	恨	
怨嗟	エンサ	恨	
怨色	エンショク	恨	
えーっ	エーッ	驚	
おいおい	オイオイ	あ見	
美味しい	オイシイ	幸	
謳歌	オウカ	幸楽喜	
嘔吐	オウト	辛苦	
懊悩	オウノウ	悩苦	
大恥	オウハジ	恥	
大喜び	オウヨロコビ	喜	
嗚咽	オエツ	苦辛	
おぉ	オォ	驚	
おお	オオ	驚	
男男しい	オオシイ	興	
岡惚れ	オカボレ	好	
岡焼き	オカヤキ	妬	
御気に入り	オキニイリ	好	
お気に入り	オキニハイリ	好	
臆する	オクスル	た	
臆病	オクビョウ	た焦驚	
臆面	オクメン	た	
臆面もなく	オクメンモナク	不	
怒らせる	オコラセル	怒	
怒り出す	オコリダス	怒	
怒り付ける	オコリツケル	怒	
怒る	オコル	怒	
惜しい	オシイ	悔	
惜しがる	オシガル	残	
惜し気	オシゲ	残	
押し付けがましい	オシツケガマシイ	不嫌	
惜しむ	オシム	残悲	
怖気付く	オジケツク	怖	
汚辱	オジョク	怒不	
恐る恐る	オソルオソル	怖	
恐れ	オソレ	恐怖	
恐れ入る	オソレイル	恐	
恐れ多い	オソレオオイ	恐	
恐れる	オソレル	怖	
恐ろしい	オソロシイ	怖	
恐ろしがる	オソロシガル	怖	
恐ろしさ	オソロシサ	怖	
おぞましい	オゾマシイ	怖嫌不	
落ち着かない	オチツカナイ	ふ焦あ	
落ち着き	オチツキ	穏	
落ち着き払う	オチツキハラウ	穏	
落ち着く	オチツク	穏	
落ち着ける	オチツケル	穏	
おっ	オッ	驚	
おっかない	オッカナイ	怖	
躍り上がる	オドリアガル	楽	
おどろおどろしい	オドロオドロシイ	怖不嫌	
驚かす	オドロカス	驚	
驚き	オドロキ	驚	
驚き呆れる	オドロキアキレル	あ驚	
驚き入る	オドロキイル	驚	
驚く	オドロク	驚	
戦き	オノノキ	怖	
戦く	オノノク	怖興	
怯え	オビエ	怖驚	
怯え切る	オビエキル	怖	
怯える	オビエル	怖	
思し召す	オボシメス	尊	
溺れる	オボレル	苦辛好	
怖めず臆せず	オメズオクセズ	穏	
おめでたい	オメデタイ	祝	
おめでとう	オメデトウ	祝	
おもいがけない	オモイガケナイ	驚	
思い屈する	オモイクッスル	鬱	
思い焦がれる	オモイコガレル	尊	
思い詰める	オモイツメル	鬱悩	
思い悩む	オモイナヤム	鬱苦	
思い残す	オモイノコス	悔	
思いの外	オモイノホカ	驚	
思い惑う	オモイマドウ	困	
思い迷う	オモイマヨウ	困	
思いも寄らず	オモイモヨラズ	驚	
思いも寄らない	オモイモヨラナイ	驚	
思いも寄らぬ	オモイモヨラヌ	驚	
思い遣り	オモイヤリ	安親	
思い遣る	オモイヤル	安親	
思い煩う	オモイワズラウ	悩苦	
重苦しい	オモクルシイ	苦不	
重苦しさ	オモクルシサ	苦不	
面白い	オモシロイ	楽	
面白かった	オモシロカッタ	楽	
面白がる	オモシロガル	楽	
面白くない	オモシロクナイ	不	
面憎い	オモニクイ	嫌恨	
重荷を下ろす	オモニヲオロス	安	
面映い	オモハユイ	恥	
おもろい	オモロイ	楽	
重んじる	オモンジル	尊	
親心	オヤゴコロ	親好尊安	
おろおろ	オロオロ	焦ふ	
愚か	オロカ	見あ	
おろかしい	オロカシイ	見あ	
愚かしい	オロカシイ	見あ	
恩愛	オンアイ	好親安	
恩寵	オンチョウ	尊親	
怨念	オンネン	怖恨	
快感	カイカン	気	
怪奇	カイキ	嫌怖	
懐旧	カイキュウ	安親	
懐郷	カイキョウ	安親	
懐古	カイコ	安親	
悔恨	カイコン	悔恨	
悔悟	カイゴ	悔	
快哉	カイサイ	気	
快楽	カイラク	気楽幸	
顔を赤らめる	カオオアカラメル	恥	
顔を隠す	カオオカクス	恥	
顔を曇らせる	カオオクモラセル	不	
顔をしかめる	カオオシカメル	怒	
顔から火が出る	カオカラヒガデル	恥	
顔が火照る	カオガホテル	恥	
掻き暗れる	カキクレル	鬱悲	
掻き毟られる	カキムシラレル	辛苦	
隔意	カクイ	恐	
鶴首	カクシュ	興	
嚇怒	カクド	怒	
かぐわしい	カグワシイ	好	
陰る	カゲル	鬱	
風向きが悪い	カザムキガワルイ	不	
畏まる	カシコマル	恐	
呵責	カシャク	怒	
片恨み	カタウラミ	恨	
肩を落とす	カタオオトス	残	
片想い	カタオモイ	切	
固くなる	カタクナル	ふ焦	
堅苦しい	カタクルシイ	不	
かたじけない	カタジケナイ	恐	
肩の荷が下りる	カタノニガオリル	安	
片腹痛い	カタハライタイ	辛苦	
肩身が狭い	カタミガセマイ	辛不	
肩身が広い	カタミガヒロイ	安親	
かちっと来る	カチットクル	怒	
勝ち誇る	カチホコル	誇	
隔靴掻痒	カッカソウヨウ	怒不	
かったるい	カッタルイ	不	
渇望	カツボウ	願	
哀しい	カナシイ	悲	
悲しい	カナシイ	悲	
悲しがる	カナシガル	悲	
悲しさ	カナシサ	悲	
哀しさ	カナシサ	悲	
悲しまれる	カナシマレル	悲	
悲しみ	カナシミ	悲	
悲しむ	カナシム	悲	
叶わない	カナワナイ	悲残悔	
雷に打たれる	カミナリニウタレル	驚	
絡む	カラム	不怒	
軽がろしい	カロガロシイ	安	
軽んじる	カロンジル	見	
軽んずる	カロンズル	見	
可愛がる	カワイガル	好安親	
可哀想	カワイソウ	憐	
奸悪	カンアク	嫌	
感悦	カンエツ	動喜	
感慨	カンガイ	動	
感慨無量	カンガイムリョウ	動	
汗顔	カンガン	恥	
歓喜	カンキ	喜	
感泣	カンキュウ	動	
感興	カンキョウ	動興	
感極まる	カンキワマル	喜幸動	
艱苦	カンク	悩苦	
感激	カンゲキ	動	
歓呼	カンコ	喜	
感謝	カンシャ	感	
癇癪	カンシャク	怒	
感傷	カンショウ	憐	
歓笑	カンショウ	喜楽	
歓心	カンシン	喜	
寒心	カンシン	怖	
感心	カンシン	驚あ動	
莞爾	カンジ	幸安親	
感じ入る	カンジイル	動	
感情的	カンジョウテキ	興怒	
感情を害する	カンジョウヲガイスル	不嫌	
感情を昂らせる	カンジョウヲタカブラセル	興	
歓声	カンセイ	興喜	
感嘆	カンタン	興驚悲	
歓天喜地	カンテンキチ	喜	
感動	カンドウ	動	
感に堪える	カンニコタエル	興動	
癇に障る	カンニサワル	怒	
感に堪えない	カンニタエナイ	興動	
勘忍袋の緒が切れる	カンニンブクロノオガキレル	怒	
感服	カンプク	尊悔	
感無量	カンムリョウ	喜幸	
感銘	カンメイ	動	
寛容	カンヨウ	安	
歓楽	カンラク	喜楽	
感涙	カンルイ	感動	
歓を尽くす	カンヲツクス	楽	
賀意	ガイ	祝	
慨然	ガイゼン	鬱怒興	
慨嘆	ガイタン	鬱怒	
愕然	ガクゼン	驚	
がっかり	ガッカリ	残	
がっくり	ガックリ	残	
我慢ならない	ガマンナラナイ	怒	
がみがみ	ガミガミ	不	
がめつい	ガメツイ	不	
気鬱	キウツ	鬱	
消え入りたい	キエイリタイ	鬱	
喜悦	キエツ	喜	
気後れ	キオクレ	怠	
気落ち	キオチ	怠	
気を揉む	キオモム	ふ	
気を悪くする	キオワルクスル	怒嫌不	
気がある	キガアル	好	
気が置かれる	キガオカレル	緊	
気が重い	キガオモイ	鬱	
気懸かり	キガカリ	ふ	
気が軽い	キガカルイ	安穏	
気が気でない	キガキデナイ	焦心ふ	
気が沈む	キガシズム	鬱残	
気が急く	キガセク	焦	
気が立つ	キガタツ	怒	
気が咎める	キガトガメル	情	
気兼ね	キガネ	緊	
気が引き締まる	キガヒキシマル	緊興	
気が参る	キガマイル	怠	
気が滅入る	キガメイル	怠	
気が揉める	キガモメル	安	
気が緩む	キガユルム	安	
気が楽	キガラク	安	
気軽	キガル	安	
気軽い	キガルイ	安	
嬉嬉	キキ	喜楽	
聞き苦しい	キキグルシイ	不	
聞き捨てならない	キキズテナラナイ	不	
聞き辛い	キキズライ	不	
聞きにくい	キキニクイ	不	
危懼	キク	心ふ	
危惧	キグ	心ふ	
気苦労	キグロウ	苦	
危険	キケン	ふ	
機嫌好い	キゲンヨイ	穏	
きざっぽい	キザッポイ	不	
気障り	キザワリ	Ｆ不	
キショい	キショイ	不	
喜色	キショク	喜	
気色が悪い	キショクガワルイ	Ｆ嫌	
気色を害する	キショクヲガイスル	怒	
気色を悪くする	キショクヲワルクスル	怒	
傷痕	キズアト	辛苦	
気遣い	キズカイ	尊怖	
気遣う	キズカウ	尊心	
気遣わしい	キズカワシイ	ふ心	
傷付く	キズツク	苦悲切	
気忙しい	キゼワシイ	焦	
気忙しさ	キゼワシサ	焦	
汚い	キタナイ	Ｆ不嫌	
汚らしい	キタナラシイ	不嫌	
狐に撮まれたよう	キツネニツママレタヨウ	驚	
気詰まり	キヅマリ	苦	
気に入る	キニイル	好幸	
気に食わない	キニクワナイ	不嫌	
気に障る	キニサワル	怒不Ｆ	
気になる	キニナル	好	
気に入らない	キニハイラナイ	不嫌	
気に病む	キニヤム	鬱心悩	
気抜け	キヌケ	怠	
気の毒	キノドク	憐	
気恥ずかしい	キハズカシイ	恥	
気恥ずかしさ	キハズカシサ	恥	
厳しい	キビシイ	苦辛	
気塞ぎ	キフサギ	鬱怠	
気分が和む	キブンガナゴム	穏安	
気分が弾む	キブンガハズム	楽	
気まずい	キマズイ	き	
気まずさ	キマズサ	き	
きまりが悪い	キマリガワルイ	恥	
気味が悪い	キミガワルイ	不嫌	
気味悪い	キミワルイ	不嫌	
気味悪さ	キミワルサ	不嫌	
気持ちいい	キモチイイ	気	
気持ちが傷付けられる	キモチガキズツケラレル	悲苦辛	
気持ちが沈む	キモチガシズム	鬱怠	
気持ちが和む	キモチガナゴム	安	
気持ちが晴れる	キモチガハレル	気	
気持ちが晴れ渡る	キモチガハレワタル	気	
気持ちが好い	キモチガヨイ	気	
気持ちが悪くなる	キモチガワルクナル	辛苦	
気持ちの好いものではない	キモチノヨイモノデワナイ	不嫌	
気持ちよい	キモチヨイ	気	
気持ち良い	キモチヨイ	気	
気持ち悪い	キモチワルイ	不嫌辛苦	
肝を潰す	キモヲツブス	驚	
肝を冷やす	キモヲヒヤス	驚怖	
きゃあ	キャア	驚怖	
キャッ	キャッ	驚	
気安い	キヤスイ	安	
窮屈	キュウクツ	不	
窮する	キュウスル	困悩苦	
杞憂	キユウ	ふ焦心	
驚異	キョウイ	驚	
恐悦	キョウエツ	感喜	
恭賀	キョウガ	祝	
驚愕	キョウガク	驚	
驚懼	キョウガク	驚	
興が醒める	キョウガサメル	不	
興がる	キョウガル	楽	
狂喜	キョウキ	喜	
驚喜	キョウキ	喜驚	
恟恟	キョウキョウ	怖	
恐懼	キョウク	恐	
恐慌	キョウコウ	怖焦	
興醒め	キョウザメ	不	
興趣	キョウシュ	楽	
郷愁	キョウシュウ	安親	
恐縮	キョウシュク	恐怖	
興じる	キョウジル	楽安	
驚嘆	キョウタン	驚	
驚天動地	キョウテンドウチ	驚	
驚倒	キョウトウ	驚	
恐怖	キョウフ	怖	
驚怖	キョウフ	怖驚	
恐怖感	キョウフカン	怖	
凶暴	キョウボウ	嫌不	
興味深い	キョウミブカイ	興好	
享楽	キョウラク	楽	
狂恋	キョウレン	好	
虚心坦懐	キョシンタンカイ	穏	
虚脱感	キョダツカン	鬱	
きょときょと	キョトキョト	ふ怖興	
きょとんとする	キョトントスル	驚	
虚無	キョム	寂悲	
嫌い	キライ	嫌	
嫌う	キラウ	嫌	
気楽	キラク	安	
気を腐らせる	キヲクサラセル	鬱	
気を呑まれる	キヲノマレル	悔	
欣快	キンカイ	喜	
欣喜	キンキ	喜	
欣喜雀躍	キンキジャクヤク	喜	
欣欣	キンキン	喜	
欣幸	キンコウ	幸喜	
欣然	キンゼン	喜	
緊張	キンチョウ	緊	
緊張感	キンチョウカン	緊	
緊張がほどける	キンチョウガホドケル	穏	
緊迫	キンパク	緊	
欣慕	キンボ	喜尊	
欣躍	キンヤク	喜	
疑懼	ギク	ふ心怖	
ぎくっ	ギクッ	驚	
ぎくり	ギクリ	驚	
ぎっくり	ギックリ	驚	
義憤	ギフン	怒	
ぎゃあ	ギャア	驚怖	
逆上	ギャクジョウ	怒	
仰天	ギョウテン	驚	
御慶	ギョケイ	祝	
ぎょっとする	ギョットスル	怖	
苦	ク	苦	
悔い	クイ	悔	
悔いる	クイル	悔	
空虚	クウキョ	寂悲	
臭い	クサイ	不	
腐る	クサル	鬱	
くしゃくしゃな顔	クシャクシャナカオ	喜	
苦笑	クショウ	不	
苦渋	クジュウ	苦悩	
くすくす	クスクス	楽安	
くすぐったい	クスグッタイ	安恥	
くだらない	クダラナイ	不あ	
口煩い	クチウルサイ	不	
口惜しい	クチオシイ	悔残	
くちぎたない	クチギタナイ	不Ｆ	
唇を噛む	クチビルオカム	悔怒	
くちやかましい	クチヤカマシイ	不	
苦衷	クチュウ	苦辛	
喰って掛かる	クッテカカル	怒不	
苦痛	クツウ	苦悩	
屈辱	クツジョク	悔恥	
屈辱感	クツジョクカン	悔	
寛ぎ	クツロギ	安穏	
寛ぐ	クツログ	安穏	
寛げる	クツロゲル	安穏	
くどい	クドイ	不	
苦悩	クノウ	苦悩	
首っ丈	クビッタケ	好	
首をすくめる	クビヲスクメル	怖	
曇る	クモル	ふ悲鬱心	
苦悶	クモン	苦心ふ	
悔しい	クヤシイ	悔	
悔しがる	クヤシガル	悔	
悔しさ	クヤシサ	悔	
悔し泣き	クヤシナキ	悔	
悔し涙	クヤシナミダ	悔	
悔み	クヤミ	悔	
悔む	クヤム	悔	
くよくよ	クヨクヨ	ふ心	
暗い	クライ	不鬱	
狂い怒る	クルイオコル	怒	
苦しい	クルシイ	苦	
苦しさ	クルシサ	苦	
苦しみ	クルシミ	苦	
苦しみ悶える	クルシミモダエル	苦	
苦しむ	クルシム	苦	
苦労	クロウ	苦辛	
具合が悪い	グアイガワルイ	心ふ苦辛	
具合悪い	グアイワルイ	心ふ苦辛	
愚図愚図	グズグズ	不	
愚図る	グズル	不	
ぐっと来る	グットクル	動	
敬愛	ケイアイ	尊親	
慶賀	ケイガ	喜祝	
慶祝	ケイシュク	喜祝	
慶する	ケイスル	喜祝	
傾倒	ケイトウ	好尊親	
敬服	ケイフク	尊	
敬慕	ケイボ	尊	
気圧される	ケオサレル	悔	
汚らわしい	ケガラワシイ	不嫌Ｆ	
毛嫌い	ケギライ	嫌	
気色ばむ	ケシキバム	怒	
懸想	ケソウ	好	
気怠い	ケダルイ	怠	
血相を変える	ケッソウヲカエル	動怒	
血涙	ケツルイ	怒悲	
懸念	ケネン	ふ心	
けばけばしい	ケバケバシイ	不嫌	
煙い	ケムイ	不	
煙たい	ケムタイ	不	
けろっ	ケロッ	穏	
けろり	ケロリ	穏	
慊焉	ケンエン	不幸	
倦厭	ケンエン	不	
嫌悪	ケンオ	嫌	
嫌悪感	ケンオカン	嫌	
嫌忌	ケンキ	嫌	
倦怠	ケンタイ	不	
倦怠感	ケンタイカン	怠	
権幕	ケンマク	怒	
激越	ゲキエツ	興怒	
激語	ゲキゴ	興怒	
激賞	ゲキショウ	祝	
激情	ゲキジョウ	興	
激する	ゲキスル	興怒	
激怒	ゲキド	怒	
激憤	ゲキフン	怒	
逆鱗に触れる	ゲキリンニフレル	怒	
げっ	ゲッ	驚不	
激昂	ゲッコウ	怒興	
げっそり	ゲッソリ	怠鬱	
下品	ゲヒン	不嫌	
下劣	ゲレツ	不嫌	
元気	ゲンキ	気	
減退	ゲンタイ	鬱怠	
げんなり	ゲンナリ	不怠	
幻滅	ゲンメツ	失	
恋	コイ	好切	
恋い焦がれる	コイコガレル	好切	
恋心	コイゴコロ	好切	
恋しい	コイシイ	好切悲	
恋しさ	コイシサ	好切悲	
恋する	コイスル	好切	
冀う	コイネガウ	願	
恋う	コウ	好切	
厚意	コウイ	好親	
好意	コウイ	好親	
光栄	コウエイ	誇	
厚恩	コウオン	感尊	
後悔	コウカイ	悔	
交歓	コウカン	楽喜	
好感	コウカン	好	
慷慨	コウガイ	怒	
好機	コウキ	興	
耿耿	コウコウ	ふ心	
恍惚	コウコツ	好	
恍惚感	コウコツカン	好	
厚志	コウシ	尊親安恐	
昂進	コウシン	興	
厚情	コウジョウ	尊親安恐	
困じる	コウジル	困	
困ずる	コウズル	困	
昂然	コウゼン	誇興	
浩然	コウゼン	穏	
紅潮	コウチョウ	恥怒	
幸福	コウフク	幸	
幸福感	コウフクカン	幸	
公憤	コウフン	怒	
興奮	コウフン	興	
昂揚	コウヨウ	興	
荒涼	コウリョウ	寂鬱不尊	
紅涙	コウルイ	悲	
小煩い	コウルサイ	不	
声を荒立てる	コエオアラダテル	怒	
声が潤む	コエガウルム	悲切寂	
小躍り	コオドリ	喜	
焦がれる	コガレル	尊願	
小汚い	コギタナイ	不	
酷悪	コクアク	嫌	
焦げ臭い	コゲクサイ	不	
心地良い	ココチヨイ	安	
心地良さ	ココチヨサ	安	
心憂い	ココロウレイ	鬱	
心後れ	ココロオクレ	鬱怖	
心悲しい	ココロカナシイ	悲	
心悲しさ	ココロカナシサ	悲	
心が痛む	ココロガイタム	悲憐	
心が動かされる	ココロガウゴカサレル	動	
心が重い	ココロガオモイ	悲切	
心懸かり	ココロガカリ	ふ心	
心が傷付く	ココロガキズツク	悲切	
心が傷付けられる	ココロガキズツケラレル	悲切	
心が弾む	ココロガハズム	楽	
心が張り詰める	ココロガハリツメル	焦ふ	
心が細る	ココロガホソル	ふ	
心苦しい	ココログルシイ	苦き	
心苦しさ	ココログルシサ	苦き	
心淋しい	ココロサビシイ	寂悲	
心遣い	ココロズカイ	安親	
心強い	ココロズヨイ	安	
心憎い	ココロニクイ	憎動興	
心の痛み	ココロノイタミ	辛	
心の傷	ココロノキズ	悲辛	
心残り	ココロノコリ	悔	
心細い	ココロボソイ	ふ心	
心細さ	ココロボソサ	ふ心	
心持ちが好くない	ココロモチガヨクナイ	ふ心	
心持ちが悪い	ココロモチガワルイ	ふ心	
心許ない	ココロモトナイ	ふ	
心安い	ココロヤスイ	安親	
心行く	ココロユク	安気	
快い	ココロヨイ	気	
快く思わない	ココロヨクオモワナイ	不嫌	
心を奪われる	ココロヲウバワレル	好	
心を砕く	ココロヲクダク	ふ心	
心を遣る	ココロヲヤル	親尊幸	
小淋しい	コサビシイ	寂	
小賢しい	コザカシイ	不嫌	
腰を抜かす	コシオヌカス	驚怖	
小癪	コシャク	不嫌	
小突かれる	コズカレル	苦嫌不	
姑息	コソク	嫌不	
こそばゆい	コソバユイ	恥	
小面憎い	コヅラニクイ	嫌憎	
孤独	コドク	悲寂切	
孤独感	コドクカン	悲寂切	
小憎らしい	コニクラシイ	憎	
好ましい	コノマシイ	好	
好ましさ	コノマシサ	好	
好まない	コノマナイ	嫌	
好み	コノミ	好	
好む	コノム	好	
困り切る	コマリキル	困	
困り抜く	コマリヌク	困	
困り果てる	コマリハテル	困	
困る	コマル	困	
小難しい	コムズカシイ	不	
小やかましい	コヤカマシイ	不嫌	
こらぁ	コラァ	怒	
懲り懲り	コリゴリ	怠	
怖	コワ	怖	
怖い	コワイ	怖	
恐い	コワイ	怖	
怖がる	コワガル	怖	
怖怖	コワゴワ	怖	
恐恐	コワゴワ	怖	
怖さ	コワサ	怖	
強張る	コワバル	怖	
困却	コンキャク	困	
困窮	コンキュウ	困	
困苦	コンク	困苦	
困惑	コンワク	困	
合歓	ゴウカン	喜	
号泣	ゴウキュウ	動辛苦喜	
号哭	ゴウコク	動辛苦喜	
業腹	ゴウハラ	怒	
強欲	ゴウヨク	不嫌	
業を煮やす	ゴウヲニヤス	怒	
御機嫌	ゴキゲン	気	
ゴメン	ゴメン	謝	
最愛	サイアイ	好安親	
最悪	サイアク	嫌	
再燃	サイネン	興	
幸い	サイワイ	幸	
逆恨み	サカウラミ	恨	
蔑む	サゲスム	見	
差出がましい	サシデシガマシイ	恐	
殺気立つ	サッキタツ	興	
さっぱり	サッパリ	気	
さばさば	サバサバ	気	
寂しい	サビシイ	寂	
淋しい	サビシイ	寂	
淋しがる	サビシガル	寂	
淋しさ	サビシサ	寂	
寒気	サムケ	怖	
寒寒	サムザム	悲寂	
さめざめ	サメザメ	悲辛寂苦	
冷める	サメル	失	
騒がしい	サワガシイ	不	
騒ぎ立つ	サワギタツ	不	
爽やか	サワヤカ	気	
鑽仰	サンギョウ	尊	
讃嘆	サンタン	尊	
三拝九拝	サンパイキュウハイ	恐尊感	
慚愧	ザンキ	恥	
残念	ザンネン	残	
幸せ	シアワセ	幸	
私怨	シエン	恨	
しおしお	シオシオ	残	
しかめっ面	シカメッツラ	悲嫌Ｆ	
しかめる	シカメル	悲嫌Ｆ	
叱り付ける	シカリツケル	怒	
叱り飛ばす	シカリトバス	怒	
叱る	シカル	怒	
しくしく	シクシク	悲	
四苦八苦	シクハック	苦	
嗜好	シコウ	好	
至情	シジョウ	安親	
静まる	シズマル	怖安	
沈み込む	シズミコム	鬱怠	
沈む	シズム	鬱怠	
慕い寄る	シタイヨル	尊親	
慕う	シタウ	尊親	
舌打ち	シタウチ	不怒	
親しみ	シタシミ	尊親	
親しむ	シタシム	尊親	
したり顔	シタリガオ	誇	
慕わしい	シタワシイ	尊親	
七面倒臭い	シチメンドウクサイ	不	
嫉視	シッシ	妬	
叱責	シッセキ	怒	
叱咤	シッタ	怒親	
失墜感	シッツイカン	失	
嫉妬	シット	憎妬	
失意	シツイ	残失	
しつこい	シツコイ	不Ｆ	
失望	シツボウ	失	
失望感	シツボウカン	失	
失恋	シツレン	切悲失辛苦鬱怠	
忍び泣き	シノビナキ	悲寂辛苦	
忍び泣く	シノビナク	悲寂辛苦	
偲ぶ	シノブ	尊悲辛苦	
痺れる	シビレル	興動辛	
私憤	シフン	怒	
渋る	シブル	た	
思慕	シボ	好尊親	
湿っぽい	シメッポイ	不	
湿っぽさ	シメッポサ	不	
湿る	シメル	不嫌安	
謝意	シャイ	感	
癪	シャク	怒	
癪に障る	シャクニサワル	怒	
しゃくり上げる	シャクリアゲル	悲辛苦	
しゃくり泣き	シャクリナキ	悲辛苦	
醜悪	シュウアク	不嫌憐	
秋思	シュウシ	寂	
愁思	シュウシ	悲	
愁傷	シュウショウ	悲	
周章	シュウショウ	焦	
周章狼狽	シュウショウロウバイ	焦	
愁色	シュウショク	鬱	
愁然	シュウゼン	鬱	
愁訴	シュウソ	苦悲	
愁嘆	シュウタン	悲	
羞恥	シュウチ	恥	
羞恥心	シュウチシン	恥	
祝着	シュウチャク	祝喜	
愁眉	シュウビ	ふ心	
愁眉を開く	シュウビヲヒラク	安	
秋風落莫	シュウフウラクバク	寂	
祝意	シュクイ	祝喜	
宿怨	シュクエン	恨	
祝賀	シュクガ	祝喜	
祝する	シュクスル	祝	
朱を注ぐ	シュヲソソグ	恥怒	
春愁	シュンシュウ	悲	
鍾愛	ショウアイ	好親	
憧憬	ショウケイ	尊親	
衝撃	ショウゲキ	驚動	
悄悄	ショウショウ	鬱怠安	
悄悄と	ショウショウト	鬱怠安	
傷心	ショウシン	悲切	
焦心	ショウシン	悩怒	
憔悴	ショウスイ	辛苦	
悚然	ショウゼン	ふ怖	
悄然	ショウゼン	鬱寂怠	
焦躁	ショウソウ	怒焦	
賞嘆	ショウタン	祝	
悄沈	ショウチン	怠	
焦慮	ショウリョ	焦怒	
性悪	ショウワル	嫌	
食指を動かす	ショクシオウゴカス	興	
食傷	ショクショウ	不辛苦	
悄気返る	ショゲカエル	失悲寂悔	
悄気る	ショゲル	失悲寂悔	
ショッキング	ショッキング	驚悲	
ショック	ショック	驚悲	
しょぼしょぼ	ショボショボ	悲	
しょぼたれる	ショボタレル	悲	
しょんぼり	ションボリ	悲	
白ける	シラケル	き	
しらける	シラケル	き	
親愛	シンアイ	親尊	
震撼	シンカン	驚怖	
心外	シンガイ	不嫌驚	
震駭	シンガイ	ふ驚怖	
辛気臭い	シンキクサイ	不嫌	
呻吟	シンギン	苦辛	
辛苦	シンク	辛苦	
神経が張り詰める	シンケイガハリツメル	緊	
深謝	シンシャ	感	
心酔	シンスイ	好尊	
親善	シンゼン	親尊好	
心臓が止まる	シンゾウガトマル	驚	
心中穏やかでない	シンチュウオダヤカデナイ	怒	
心痛	シンツウ	憐	
しんどい	シンドイ	辛苦	
心配	シンパイ	心	
心服	シンプク	尊好	
しんみり	シンミリ	寂	
心労	シンロウ	苦悩辛	
辛労	シンロウ	苦辛	
慈愛	ジアイ	安親	
じいんと	ジイント	辛苦動	
自棄	ジキ	怒焦	
自虐	ジギャク	辛苦	
忸怩	ジクジ	恥	
自己嫌悪	ジコケンオ	情	
自失	ジシツ	鬱	
ジジくさい	ジジクサイ	不	
自若	ジジャク	穏	
自責	ジセキ	情	
地団太を踏む	ジダンダオフム	悔	
自嘲	ジチョウ	情	
慈悲	ジヒ	憐	
自暴自棄	ジボウジキ	鬱	
自慢たらしい	ジマンタラシイ	不	
じめじめ	ジメジメ	不Ｆ	
寂然	ジャクネン	寂	
雀躍	ジャクヤク	喜	
邪魔	ジャマ	不	
邪魔くさい	ジャマクサイ	不	
充実感	ジュウジツカン	喜楽	
情	ジョウ	情	
情愛	ジョウアイ	好親	
情炎	ジョウエン	興好	
上気	ジョウキ	怒	
上機嫌	ジョウキゲン	楽喜	
情熱	ジョウネツ	興	
情欲	ジョウヨク	好興	
焦らす	ジラス	不怒	
じりじり	ジリジリ	不	
焦れったい	ジレッタイ	不	
焦れったがる	ジレッタガル	不	
焦れったさ	ジレッタサ	不	
焦れる	ジレル	不	
仁愛	ジンアイ	親	
すうっと	スウット	気安	
末恐ろしい	スエオソロシイ	ふ	
すえたのもしい	スエタノモシイ	願興	
好かない	スカナイ	嫌	
清々しい	スガスガシイ	気	
好き	スキ	好	
好き好む	スキコノム	好	
救われる	スクワレル	喜	
すごすご	スゴスゴ	鬱怠	
荒む	スサム	鬱怠	
啜り上げる	ススリアゲル	悲辛	
啜り泣き	ススリナキ	悲切	
啜り泣く	ススリナク	悲切	
すっきり	スッキリ	気	
素っ頓狂	スットンキョウ	驚あ	
捨て台詞	ステゼリフ	不怒	
捨て鉢	ステバチ	怒	
素晴らしい	スバラシイ	動	
すまん	スマン	謝	
随喜	ズイキ	喜安	
図々しい	ズウズウシイ	不	
杜撰	ズサン	不	
清清	セイセイ	気	
凄絶	セイゼツ	興	
凄愴	セイソウ	憐	
青天の霹靂	セイテンノヘキレキ	驚	
積怨	セキエン	恨	
急き込む	セキコム	焦	
寂莫	セキバク	寂	
寂莫感	セキバクカン	寂	
積憤	セキフン	怒	
赤面	セキメン	恥	
寂寥	セキリョウ	寂	
寂寥感	セキリョウカン	寂	
せこい	セコイ	不	
背筋が氷つく	セスジガコオリツク	怖	
背筋が凍る	セスジガコオル	怖	
世知辛い	セチツライ	不	
切ない	セツナイ	切	
切ない思い	セツナイオモイ	切	
切なさ	セツナサ	切	
狭苦しい	セマクルシイ	不	
責め苦	セメク	苦	
戦意	センイ	興	
戦々恐々	センセンキョウキョウ	ふ怖	
センチメンタル	センチメンタル	鬱	
羨望	センボウ	妬	
旋毛を曲げる	センモウヲマゲル	妬	
戦慄	センリツ	怖	
戦慄感	センリツカン	怖	
鮮烈	センレツ	興驚	
絶句	ゼック	驚あ	
絶好調	ゼッコウチョウ	気興	
絶体絶命	ゼッタイゼツメイ	ふ心焦	
絶頂感	ゼッチョウカン	気興	
絶望	ゼツボウ	失	
粗悪	ソアク	嫌不	
壮快	ソウカイ	気	
爽快	ソウカイ	気	
総毛立つ	ソウケタツ	怖	
相好を崩す	ソウゴウヲクズス	喜楽安穏	
相思相愛	ソウシソウアイ	好安	
壮絶	ソウゼツ	苦辛	
騒々しい	ソウゾウシイ	不	
蒼白	ソウハク	ふ心焦	
爽涼	ソウリョウ	気	
惻隠	ソクイン	憐	
沮喪	ソソウ	鬱怠	
嫉み	ソネミ	妬	
嫉む	ソネム	妬	
空恐ろしい	ソラオソロシイ	ふ怖	
空恐ろしさ	ソラオソロシサ	ふ怖	
空空しい	ソラゾラシイ	不嫌	
空恥ずかしい	ソラハズカシイ	恥	
空喜び	ソラヨロコビ	喜	
そわそわ	ソワソワ	焦	
憎悪	ゾウオ	嫌憎	
憎悪感	ゾウオカン	嫌憎	
俗悪	ゾクアク	不嫌	
ぞくぞくする	ゾクゾクスル	怖興	
俗っぽい	ゾクッポイ	不	
ぞっこん	ゾッコン	好	
ぞっとしない	ゾットシナイ	不嫌	
ぞっとする	ゾットスル	怖	
存外	ゾンガイ	驚	
大慶	タイケイ	喜祝	
大切	タイセツ	親尊安	
泰然	タイゼン	穏	
泰然自若	タイゼンジジャク	穏	
大息	タイソク	鬱怠	
怠惰	タイダ	怠不	
高鳴る	タカナル	興	
高飛車	タカビシャ	怒	
昂り	タカブリ	興	
昂	タカブリ	興	
昂ぶる	タカブル	興	
高笑い	タカワライ	喜楽	
多岐亡羊	タキボウヨウ	鬱悩	
たくましい	タクマシイ	興	
猛り狂う	タケリクルウ	興	
猛り立つ	タケリタツ	興	
猛る	タケル	興	
多謝	タシャ	感	
たじたじ	タジタジ	驚焦興	
たじろぐ	タジログ	驚焦興	
助かりました	タスカリマシタ	感	
助かります	タスカリマス	感	
立ち竦む	タチスクム	驚怖	
愉しい	タノシイ	楽	
楽しい	タノシイ	楽	
楽しかった	タノシカッタ	楽	
楽しがる	タノシガル	楽	
楽しさ	タノシサ	楽	
楽しみ	タノシミ	楽	
楽しむ	タノシム	楽	
頼もしい	タノモシイ	安興	
たまげる	タマゲル	驚	
魂を奪われたよう	タマシイヲウバワレタヨウ	鬱	
堪らない	タマラナイ	好怒	
堪り兼ねる	タマリカネル	好怒	
溜息	タメイキ	鬱怠	
ため息をつく	タメイキヲツク	鬱怠	
躊躇い	タメライ	き	
躊躇う	タメラウ	き	
揺蕩う	タユタウ	き	
弛み	タユミ	怠安	
弛む	タユム	安怠	
頼り無い	タヨリナイ	ふ心	
頼りなさ	タヨリナサ	ふ心	
嘆賞	タンショウ	尊	
嘆じる	タンジル	祝	
嘆ずる	タンズル	祝鬱	
嘆声	タンセイ	祝鬱	
嘆息	タンソク	祝鬱	
淡淡	タンタン	好気	
耽溺	タンデキ	好	
嘆美	タンビ	祝動	
大悦	ダイエツ	喜	
大嫌い	ダイキライ	嫌	
大事	ダイジ	親安驚焦興	
大好き	ダイスキ	好	
惰気	ダキ	怠	
ダサい	ダサイ	不	
だらしない	ダラシナイ	不	
怠い	ダルイ	怠不	
だるい	ダルイ	不	
だれ気味	ダレキミ	怠	
だれる	ダレル	怠	
断腸の思い	ダンチョウノオモイ	悲	
小さくなる	チイサクナル	恐	
力を落とす	チカラオオトス	失鬱残	
力落し	チカラオトシ	失鬱残	
力が抜ける	チカラガヌケル	安	
力付く	チカラズク	興	
力強い	チカラヅヨイ	興	
力抜け	チカラヌケ	安	
ちくちく	チクチク	不	
縮こまる	チジコマル	ふ怖	
縮み上がる	チジミアガル	ふ怖	
恥辱	チジョク	恥怒	
恥辱感	チジョクカン	恥怒	
血なまぐさい	チナマグサイ	不	
血の気が引く	チノケガヒク	怖	
血の涙	チノナミダ	辛悲苦	
血走る	チバシル	怒興	
血迷う	チマヨウ	怒怖	
チャーミング	チャーミング	好	
躊躇	チュウチョ	た	
惆悵	チュウチョウ	恨悲	
中っ腹	チュウッパラ	不怒Ｆ	
寵愛	チョウアイ	親安	
弔意	チョウイ	悲恨	
悵然	チョウゼン	失恨鬱	
長嘆	チョウタン	鬱	
沈鬱	チンウツ	鬱怠	
鎮静	チンセイ	安	
沈潜	チンセン	好	
沈着	チンチャク	好	
沈痛	チンツウ	悲鬱	
追悼	ツイトウ	悲	
追慕	ツイボ	悲切	
痛快	ツウカイ	気楽	
痛快さ	ツウカイサ	気楽	
痛快味	ツウカイミ	気楽	
痛哭	ツウコク	悲鬱	
痛恨	ツウコン	失残	
痛心	ツウシン	悲切辛苦	
痛惜	ツウセキ	悲	
痛嘆	ツウタン	悲鬱	
痛憤	ツウフン	怒	
痛痒	ツウヨウ	苦辛	
閊えが下がる	ツカエガサガル	気安	
閊えが取れる	ツカエガトレル	気安	
つまらない	ツマラナイ	不	
つまんない	ツマンナイ	不	
冷たい	ツメタイ	不	
辛い	ツライ	不辛	
辛さ	ツラサ	辛	
つれない	ツレナイ	不	
つんつん	ツンツン	不怒	
つんと	ツント	不怒	
涕泣	テイキュウ	悲辛	
啼泣	テイキュウ	悲辛	
諦念	テイネン	失悔情	
涕涙	テイルイ	悲辛切	
敵意	テキイ	嫌	
敵愾心	テキガイシン	嫌	
敵視	テキシ	嫌	
照れ隠し	テレカクシ	恥	
照れ臭い	テレクサイ	恥	
照れ臭さ	テレクササ	恥	
照れる	テレル	恥	
溺愛	デキアイ	好	
吐息	トイキ	安	
陶酔	トウスイ	尊好気	
陶然	トウゼン	安気	
尊ぶ	トウトブ	尊	
当惑	トウワク	困	
ときめかす	トキメカス	好喜	
ときめき	トキメキ	好	
ときめく	トキメク	好喜	
得意	トクイ	誇	
とげとげしい	トゲトゲシイ	不	
所得顏	トコロエガオ	安喜	
妬心	トシン	妬	
飛び上がる	トビアガル	驚	
飛び退く	トビノク	驚	
途方に暮れる	トホウニクレル	困	
トホホ	トホホ	見あ	
戸惑い	トマドイ	困焦	
戸惑う	トマドウ	困焦	
取り越し苦労	トリコシクロウ	心	
取り残される	トリノコサレル	ふ怒不	
鳥肌	トリハダ	怖Ｆ	
取り乱す	トリミダス	怒困焦	
とろい	トロイ	不	
蕩ける	トロケル	好	
怒	ド	怒	
動悸	ドウキ	ふ焦興	
同慶	ドウケイ	喜祝	
慟哭	ドウコク	悲	
瞠若	ドウジャク	驚	
同情	ドウジョウ	憐	
動じる	ドウジル	安	
動顛	ドウテン	驚焦	
胴震い	ドウブルイ	興ふ怖焦	
瞠目	ドウモク	驚動	
動揺	ドウヨウ	ふ焦	
怒気	ドキ	怒	
どきっ	ドキッ	好	
どきどき	ドキドキ	好焦	
どきり	ドキリ	怖	
どきん	ドキン	怖	
どぎつい	ドギツイ	不	
どぎまぎ	ドギマギ	ふ焦	
度肝を抜かれる	ドギモヲヌカレル	驚	
怒号	ドゴウ	怒	
怒声	ドセイ	怒	
怒鳴り込む	ドナリコム	怒	
怒鳴り散らす	ドナリチラス	怒	
怒鳴り付ける	ドナリツケル	怒	
怒鳴る	ドナル	怒	
怒罵	ドバ	怒	
どよめく	ドヨメク	驚	
どんより	ドンヨリ	不	
萎え萎む	ナエシボム	鬱	
萎える	ナエル	鬱	
長たらしい	ナガタラシイ	不	
泣き	ナキ	悲切辛	
泣き明かす	ナキアカス	悲切辛	
泣き顔	ナキガオ	悲切辛	
泣き崩れる	ナキクズレル	悲切辛	
泣き暮らす	ナキクラス	悲切辛	
泣き暮れる	ナキクレル	悲切辛	
泣き込む	ナキコム	辛願	
泣き声	ナキゴエ	悲辛嬉	
泣き叫ぶ	ナキサケブ	悲切辛	
泣き沈む	ナキシズム	悲切辛	
泣きじゃくる	ナキジャクル	悲切辛	
泣きたい	ナキタイ	悲切辛	
泣き出す	ナキダス	悲切辛	
泣き付く	ナキツク	辛願	
泣き面	ナキツラ	悲切辛	
泣き泣き	ナキナキ	悲切辛	
泣き濡れる	ナキヌレル	悲切辛	
泣き腫らす	ナキハラス	悲切辛	
泣き伏す	ナキフス	悲切辛	
泣き咽ぶ	ナキムセブ	悲切辛	
泣き別れ	ナキワカレ	悲切辛	
泣き別れる	ナキワカレル	悲切辛	
泣く	ナク	悲辛喜切	
泣く泣く	ナクナク	悲切辛	
泣ける	ナケル	興動	
嘆かわしい	ナゲカワシイ	怒見	
嘆き	ナゲキ	鬱悲	
嘆き明かす	ナゲキアカス	鬱悲	
嘆き悲しむ	ナゲキカナシム	鬱悲	
嘆く	ナゲク	鬱悲	
和やか	ナゴヤカ	安	
名残惜しい	ナゴリオシイ	切悲辛	
名残惜しむ	ナゴリオシム	切悲辛	
情けない	ナサケナイ	情	
情けなさ	ナサケナサ	情	
馴染む	ナジム	親	
懐かしい	ナツカシイ	安親	
懐かしがる	ナツカシガル	安親	
懐かしさ	ナツカシサ	安親	
懐かしみ	ナツカシミ	安親	
懐かしむ	ナツカシム	安親	
懐く	ナツク	安親	
生唾を呑む	ナマツバオノム	願好	
涙	ナミダ	悲切辛苦喜	
涙雨	ナミダアメ	悲	
涙をのむ	ナミダオノム	悔	
涙が込み上げる	ナミダガコミアゲル	辛苦	
涙ぐましい	ナミダグマシイ	憐	
涙ぐむ	ナミダグム	切悲辛	
涙声	ナミダゴエ	切悲辛	
波立つ	ナミダツ	怒	
涙に掻き暗れる	ナミダニカキクレル	悲	
涙に暮れる	ナミダニクレル	悲	
涙に咽ぶ	ナミダニムセブ	辛悲	
悩まされる	ナヤマサレル	悩	
悩ましい	ナヤマシイ	悩	
悩ます	ナヤマス	悩	
悩み	ナヤミ	悩	
悩む	ナヤム	悩	
馴れ馴れしい	ナレナレシイ	嫌	
難渋	ナンジュウ	苦困	
ナンセンス	ナンセンス	不	
なんと	ナント	驚	
なんとまあ	ナントマア	困	
煮え返る	ニエカエル	怒	
煮え繰り返る	ニエクリカエル	怒	
煮え立つ	ニエタツ	怒	
煮え湯を飲まされる	ニエユヲノマサレル	怒	
苦い	ニガイ	不	
苦いものが込み上げる	ニガイモノガコミアゲル	悔	
苦手	ニガテ	嫌	
苦々しい	ニガニガシイ	嫌Ｆ	
苦り切る	ニガリキル	嫌Ｆ	
苦る	ニガル	嫌Ｆ	
苦笑い	ニガワライ	怒嫌Ｆ	
憎い	ニクイ	憎	
憎く思う	ニククオモウ	憎	
憎しみ	ニクシミ	憎	
憎たらしい	ニクタラシイ	憎	
憎体	ニクテイ	憎	
憎々しい	ニクニクシイ	憎	
憎む	ニクム	憎	
憎らしい	ニクラシイ	憎	
憎らしさ	ニクラシサ	憎	
にこにこ	ニコニコ	喜幸安楽	
にこやか	ニコヤカ	喜幸安楽	
にたにた	ニタニタ	喜幸安楽	
にっこり	ニッコリ	喜幸安楽	
二の足を踏む	ニノアシオフム	た	
にやにや	ニヤニヤ	喜幸安楽	
にやり	ニヤリ	喜幸安楽	
睨み付ける	ニラミツケル	怒不嫌	
睨む	ニラム	怒不嫌	
人情	ニンジョウ	親	
にんまり	ニンマリ	喜幸安楽	
糠喜び	ヌカヨロコビ	喜	
寝苦しい	ネグルシイ	苦	
妬ましい	ネタマシイ	妬	
妬ましがる	ネタマシガル	妬	
妬み	ネタミ	妬	
妬み憎む	ネタミニクム	妬憎	
妬む	ネタム	妬	
ねちっこい	ネチッコイ	嫌	
熱愛	ネツアイ	好	
熱を上げる	ネツオアゲル	興	
熱情	ネツジョウ	好	
熱に浮かされる	ネツニウカサレル	辛苦好	
熱涙	ネツルイ	動	
悩殺	ノウサツ	悩好	
悩乱	ノウラン	鬱悩	
血の気が上る	ノケガノボル	怒	
残り多い	ノコリオオイ	失残悔	
残り惜しい	ノコリオシイ	失残悔	
ノスタルジア	ノスタルジア	親	
伸び伸び	ノビノビ	穏	
逆上せ	ノボセ	好	
逆上せ上がる	ノボセアガル	好	
のめり込む	ノメリコム	好	
呪い	ノロイ	妬恨憎	
呪う	ノロウ	妬恨憎	
呪わしい	ノロワシイ	妬恨憎	
暢気	ノンキ	安気穏	
のんびり	ノンビリ	穏安	
儚い	ハカナイ	切	
図らずも	ハカラズモ	驚	
歯痒い	ハガユイ	不怒	
剥れる	ハガレル	怒	
吐き気	ハキケ	嫌辛苦Ｆ	
吐気	ハキケ	嫌辛苦Ｆ	
歯軋り	ハギシリ	怒悔	
博愛	ハクアイ	安親	
激しい	ハゲシイ	怒	
はしたない	ハシタナイ	不嫌	
燥ぐ	ハシャグ	楽	
恥	ハジ	恥	
恥じ入る	ハジイル	恥	
恥をかく	ハジオカク	恥	
恥じらい	ハジライ	恥	
恥じらう	ハジラウ	恥	
恥じる	ハジル	恥	
恥ずかしい	ハズカシイ	恥	
恥ずかしがる	ハズカシガル	恥	
恥ずかしさ	ハズカシサ	恥	
はた迷惑	ハタメイワク	不	
肌が粟立つ	ハダガアワダツ	怖	
肌に粟を生じる	ハダニアワヲショウジル	怖	
はっと	ハット	驚	
ハッピー	ハッピー	安楽	
初恋	ハツコイ	切好	
鼻白む	ハナジロム	不嫌	
鼻たかだか	ハナタカダカ	誇	
はにかむ	ハニカム	恥	
腹いせ	ハライセ	怒	
腹が立つ	ハラガタツ	怒	
腹黒い	ハラグロイ	不	
腹立たしい	ハラダタシイ	怒	
腹立たしさ	ハラダタシサ	怒	
腹立ち	ハラダチ	怒	
腹立つ	ハラダツ	怒	
腹に据え兼ねる	ハラニスエカネル	怒	
腹の虫が収まらない	ハラノムシガオサマラナイ	怒	
はらはら	ハラハラ	焦興	
腸が千切れる	ハラワタガチギレル	悲	
腸を抉られる	ハラワタヲエグラレル	苦辛	
腹を立てる	ハラヲタテル	怒	
張り合いが抜ける	ハリアイガヌケル	鬱失	
晴れがましい	ハレガマシイ	気	
晴れ晴れ	ハレバレ	気	
晴れ晴れしい	ハレバレシイ	気	
晴れやか	ハレヤカ	気	
反感	ハンカン	嫌不Ｆ	
反抗心	ハンコウシン	不嫌	
煩悶	ハンモン	苦悩	
煩労	ハンロウ	悩苦	
ばかくさい	バカクサイ	あ	
ばかばかしい	バカバカシイ	あ	
バカヤロー	バカヤロ?	怒	
馬鹿らしい	バカラシイ	あ	
ばっちい	バッチイ	不嫌	
ばつが悪い	バツガワルイ	不	
万歳	バンザイ	祝喜	
悲哀	ヒアイ	悲	
悲哀感	ヒアイカン	悲	
贔屓	ヒイキ	不好	
ひいひい	ヒイヒイ	苦	
冷え切る	ヒエキル	寂鬱	
冷え冷え	ヒエビエ	寂鬱	
冷える	ヒエル	寂鬱	
悲観	ヒカン	悲	
僻み	ヒガミ	妬	
僻む	ヒガム	妬	
悲泣	ヒキュウ	悲	
卑怯	ヒキョウ	不嫌	
悲惨	ヒサン	憐	
悲秋	ヒシュウ	悲	
悲愁	ヒシュウ	悲鬱	
悲傷	ヒショウ	悲憐	
悲壮	ヒソウ	悲	
悲愴	ヒソウ	悲	
顰み	ヒソミ	嫌	
卑俗	ヒゾク	嫌	
悲嘆	ヒタン	悲	
悲痛	ヒツウ	憐	
一安心	ヒトアンシン	安	
人恋しい	ヒトコイシイ	悲切	
人懐こい	ヒトナツコイ	親	
ひとりぼっち	ヒトリボッチ	悲辛	
酷い	ヒドイ	嫌不	
悲風	ヒフウ	悲	
悲憤	ヒフン	悲怒	
悲鳴	ヒメイ	驚怖困悲	
冷や汗	ヒヤアセ	焦緊恥怖	
ひやっ	ヒヤッ	焦驚	
冷や冷や	ヒヤヒヤ	焦心ふ	
ひやり	ヒヤリ	焦驚怖緊	
拍子抜け	ヒョウシヌケ	鬱怠	
表情を強張らせる	ヒョウジョウヲコワバラセル	怖	
開いた口が塞がらない	ヒライタクチガフサガラナイ	あ	
悲涙	ヒルイ	悲	
怯む	ヒルム	怖	
卑劣	ヒレツ	不嫌怒	
悲恋	ヒレン	悲	
卑猥	ヒワイ	不嫌	
顰蹙	ヒンシュク	嫌	
びくっ	ビクッ	驚怖	
びくつく	ビクツク	ふ怖	
びくびく	ビクビク	ふ怖	
びくり	ビクリ	驚	
微笑	ビショウ	安	
吃驚	ビックリ	驚	
吃驚仰天	ビックリギョウテン	驚	
憫察	ビンサツ	憐	
ぴくぴく	ピクピク	怖	
ぴりぴり	ピリピリ	怒	
不安	フアン	ふ	
不安がる	フアンガル	ふ	
不安定	フアンテイ	不	
不快	フカイ	嫌Ｆ	
不快感	フカイカン	嫌Ｆ	
不快さ	フカイサ	嫌Ｆ	
腑甲斐無い	フガイナイ	不情	
不機嫌	フキゲン	怒	
不気味	フキミ	不	
不気味さ	フキミサ	不	
不興	フキョウ	鬱き	
不謹慎	フキンシン	不嫌	
膨れっ面	フクレッツラ	不怒	
不潔	フケツ	不	
耽る	フケル	好	
不幸	フコウ	残	
鬱ぎ込む	フサギコム	鬱	
鬱ぐ	フサグ	鬱	
伏し目	フシメ	鬱	
不承不承	フショウブショウ	不	
父性愛	フセイアイ	親	
吹っ切れる	フッキレル	気	
怫然	フツゼン	怒	
ふてぶてしい	フテブテシイ	不憎	
腑抜け	フヌケ	見	
不憫	フビン	憐見	
不憫さ	フビンサ	憐見	
不服	フフク	不	
不平	フヘイ	不怒	
不本意	フホンイ	不	
不満	フマン	不	
不満足	フマンゾク	不	
不味	フミ	不	
不面目	フメンボク	悲	
不愉快	フユカイ	嫌Ｆ	
不愉快感	フユカイカン	嫌Ｆ	
不愉快さ	フユカイサ	Ｆ	
ふらち	フラチ	嫌怒	
ふらふら	フラフラ	焦鬱緊	
不慮	フリョ	驚	
奮い起こす	フルイオコス	興	
奮い立つ	フルイタツ	興	
震い付く	フルイツク	興	
震う	フルウ	怖	
震え上がる	フルエアガル	怖	
震え戦く	フルエオノノク	怖	
震えが来る	フルエガクル	怖	
震え出す	フルエダス	怖	
震える	フルエル	怖ふ焦	
憤慨	フンガイ	怒	
奮起	フンキ	興	
憤激	フンゲキ	怒	
憤死	フンシ	怒	
憤然	フンゼン	怒	
奮然	フンゼン	怒	
憤怒	フンヌ	怒	
憤懣	フンマン	怒	
ぶうぶう	ブウブウ	不	
不格好	ブカッコウ	不	
無様	ブザマ	憐見	
憮然	ブゼン	不残驚	
物騒	ブッソウ	ふ不心	
仏頂面	ブッチョウズラ	不嫌怒	
ぶつくさ	ブツクサ	不	
ぶるぶる	ブルブル	怖ふ	
無礼	ブレイ	怒	
ぷいと	プイト	怒	
ぷりぷり	プリプリ	怒	
ぷんぷん	プンプン	怒	
平安	ヘイアン	穏	
平穏	ヘイオン	穏	
平気	ヘイキ	安	
閉口	ヘイコウ	困	
平静	ヘイセイ	穏	
平然	ヘイゼン	穏	
へいちゃら	ヘイチャラ	穏	
辟易	ヘキエキ	怒悔	
臍を曲げる	ヘソヲマゲル	怒不	
下手糞	ヘタクソ	不	
下手の横好き	ヘタノヨコズキ	好	
反吐	ヘド	嫌	
へどもど	ヘドモド	困	
偏愛	ヘンアイ	好	
べそをかく	ベソヲカク	悲辛	
法悦	ホウエツ	喜	
頬が火照る	ホウガホテル	恥	
放心	ホウシン	驚あ	
放心状態	ホウシンジョウタイ	驚あ	
法楽	ホウラク	楽	
頬を染める	ホウヲソメル	恥	
朗か	ホガラカ	安	
北叟笑む	ホクソエム	安	
ほくほく	ホクホク	喜	
誇らしい	ホコラシイ	誇	
誇らしさ	ホコラシサ	誇	
誇り	ホコリ	誇	
誇る	ホコル	誇	
綻ばす	ホコロバス	誇	
綻びる	ホコロビル	誇	
綻ぶ	ホコロブ	誇	
ほっと	ホット	安	
火照る	ホテル	恥	
仄仄	ホノボノ	安	
微笑み	ホホエミ	喜	
微笑む	ホホエム	喜	
頬を染める	ホホヲソメル	恥	
褒めそやす	ホメソヤス	祝見	
褒め讃える	ホメタタエル	祝見	
褒めちぎる	ホメチギル	祝見	
褒める	ホメル	祝見	
惚れ込む	ホレコム	好	
惚れ惚れ	ホレボレ	好	
惚れる	ホレル	好	
ほろっと	ホロット	動	
ほろ苦い	ホロニガイ	苦	
ほろほろ	ホロホロ	切辛	
ほろり	ホロリ	切辛	
望外	ボウガイ	喜	
呆然	ボウゼン	見	
惘然	ボウゼン	見	
茫然	ボウゼン	見	
暴慢	ボウマン	不嫌	
亡羊の嘆	ボウヨウノタン	悩	
慕情	ボジョウ	尊	
母性愛	ボセイアイ	親	
勃然	ボツゼン	怒	
ぼろぼろ	ボロボロ	苦辛	
ぼんやりする	ボンヤリスル	鬱怠	
ぼうっとなる	ボーットナル	鬱怠	
ぽうっとなる	ポウットナル	鬱怠	
ぽかんとする	ポカントスル	鬱怠	
ぽろぽろ	ポロポロ	悲辛苦切	
ぽろり	ポロリ	悲辛苦切	
まがまがしい	マガマガシイ	ふ	
間が悪い	マガワルイ	不	
負け惜しみ	マケオシミ	悔見	
まごつく	マゴツク	困	
まごまご	マゴマゴ	困	
まさかの	マサカノ	驚	
不味い	マズイ	不	
貧しい	マズシイ	憐見	
まだるっこい	マダルッコイ	不	
待ち焦がれる	マチコガレル	願興	
待ち遠しい	マチドウシイ	願興	
真っ暗	マックラ	不嫌ふ	
真っ青	マッサオ	怖	
真っ平	マッピラ	嫌	
惑い	マドイ	困	
惑う	マドウ	困	
惑わす	マドワス	困	
眩しい	マブシイ	好	
眉が晴れる	マユガハレル	気	
眉根を顰める	マユネオシカメル	心Ｆふ	
眉を曇らす	マユヲクモラス	ふ心	
眉を顰める	マユヲシカメル	心Ｆふ	
眉を開く	マユヲヒラク	安気	
迷い	マヨイ	悩困	
迷う	マヨウ	悩困	
回りくどい	マワリクドイ	不	
満悦	マンエツ	喜	
満更でもない	マンザラデモナイ	喜	
満足	マンゾク	喜幸	
満足感	マンゾクカン	喜幸	
満面朱を注ぐ	マンメンシュヲソソグ	恥怒	
見上げる	ミアゲル	尊	
身勝手	ミガッテ	不嫌	
見下す	ミクダス	見	
見縊る	ミクビル	見	
見苦しい	ミグルシイ	見	
見事	ミゴト	動	
見下げる	ミサゲル	見	
惨め	ミジメ	憐見	
惨めさ	ミジメサ	憐見	
みすぼらしい	ミスボラシイ	不見	
見づらい	ミズライ	不	
見染める	ミソメル	好	
満たされる	ミタサレル	幸	
乱れる	ミダレル	興鬱	
満ち足りる	ミチタリル	幸	
みっともない	ミットモナイ	不見	
みっともよくない	ミットモヨクナイ	不	
見惚れる	ミトレル	好	
醜い	ミニクイ	不Ｆ	
見憎い	ミニクイ	不憎	
身の毛が弥立つ	ミノケガヨダツ	怖	
身震いがする	ミブルイガスル	怖	
みみっちい	ミミッチイ	不	
身悶え	ミモダエ	苦	
身悶える	ミモダエル	苦	
身も縮む	ミモチジム	恐	
未練	ミレン	悔	
未練がましい	ミレンガマシイ	悔不	
身を切られる	ミヲキラレル	悲残	
身を裂く	ミヲサク	悲残	
むかっと	ムカット	怒	
向っ腹	ムカッパラ	怒	
向っ腹が立つ	ムカッパラガタツ	怒	
向っ腹を立てる	ムカッパラヲタテル	怒	
むかつく	ムカツク	怒	
むかむか	ムカムカ	怒	
無我夢中	ムガムチュウ	好	
向きになる	ムキニナル	怒	
無気力	ムキリョク	鬱	
惨たらしい	ムゴタラシイ	憐	
むさい	ムサイ	不	
むさくるしい	ムサクルシイ	不	
蒸し暑い	ムシアツイ	不	
虫酸が走る	ムシズガハシル	嫌Ｆ	
むしゃくしゃ	ムシャクシャ	怒	
むずかる	ムズカル	怒	
むず痒い	ムズガユイ	不	
むずむず	ムズムズ	興	
咽び泣き	ムセビナキ	悲辛	
咽び泣く	ムセビナク	悲辛	
咽ぶ	ムセブ	喜悲	
噎せる	ムセル	喜悲	
夢中になる	ムチュウニナル	好	
むっと	ムット	怒	
むつまじい	ムツマジイ	親好安	
胸糞が悪い	ムナクソガワルイ	怒	
胸苦しい	ムナグルシイ	苦	
胸騒ぎ	ムナサワギ	ふ心	
空しい	ムナシイ	寂切	
虚しい	ムナシイ	寂切	
虚しさ	ムナシサ	寂切	
胸躍る	ムネオドル	楽興	
胸を撫で下ろす	ムネオナデオロス	安	
胸が熱くなる	ムネガアツクナル	動	
胸が痛くなる	ムネガイタクナル	辛	
胸が一杯になる	ムネガイッパイニナル	喜悲	
胸がすく	ムネガスク	気	
胸が潰れる	ムネガツブレル	悲ふ	
胸が詰まる	ムネガツマル	苦	
胸が轟く	ムネガトドロク	興	
胸が弾む	ムネガハズム	楽興	
胸が早鐘を打つ	ムネガハヤガネヲウツ	楽興	
胸が張り裂ける	ムネガハリサケル	辛切	
胸が塞がる	ムネガフサガル	ふ憐	
胸が震える	ムネガフルエル	動	
胸が悪い	ムネガワルイ	嫌怒Ｆ	
胸につかえる	ムネニツカエル	悩鬱	
胸を痛める	ムネヲイタメル	悩	
胸を打たれる	ムネヲウタレル	動	
胸を抉られる	ムネヲエグラレル	ふ苦	
胸を躍らせる	ムネヲオドラセル	喜	
胸を焦がす	ムネヲコガス	好	
胸を締め付けられる	ムネヲシメツケラレル	切	
胸を締められる	ムネヲシメラレル	切	
胸を突かれる	ムネヲツカレル	驚	
胸を膨らませる	ムネヲフクラマセル	興	
無念	ムネン	残	
無念さ	ムネンサ	残	
無念遣る方ない	ムネンヤルカタナイ	残	
むらむら	ムラムラ	興	
滅入り込む	メイリコム	鬱怠	
滅入る	メイル	鬱怠	
迷惑	メイワク	怒	
目が潤む	メガウルム	悲辛	
目頭が熱くなる	メガシラガアツクナル	動	
目障り	メザワリ	嫌	
目尻を下げる	メジリヲサゲル	喜幸	
めずらしい	メズラシイ	驚	
めそめそ	メソメソ	悲	
めでたい	メデタイ	祝	
目に角を立てる	メニカドヲタテル	怒	
眩暈	メマイ	辛	
女々しい	メメシイ	不	
メロメロ	メロメロ	好	
目を白黒させる	メヲシロクロサセル	驚	
目をパチクリさせる	メヲパチクリサセル	驚	
眼を伏せる	メヲフセル	驚憐	
目を細める	メヲホソメル	喜	
目を丸くする	メヲマルクスル	驚	
目を瞠る	メヲミハル	驚	
目を剥く	メヲムク	怒	
面食らう	メンクラウ	驚焦	
面倒い	メンドイ	不	
面倒	メンドウ	不	
面倒臭い	メンドウクサイ	不	
面目無い	メンボクナイ	恥	
盲愛	モウアイ	好親	
申し分ない	モウシブンナイ	動	
申し訳ない	モウシワケナイ	謝	
燃え尽きる	モエツキル	鬱	
もじもじする	モジモジスル	恥	
悶え	モダエ	苦	
悶える	モダエル	苦	
もどかしい	モドカシイ	怒	
もどかしがる	モドカシガル	怒	
もどかしさ	モドカシサ	怒	
物哀れ	モノアワレ	憐	
物憂い	モノウイ	鬱	
懶い	モノウイ	鬱	
懶さ	モノウサ	鬱	
物怖じ	モノオジ	恐	
物恐ろしい	モノオソロシイ	怖	
物思い	モノオモイ	悩	
物悲しい	モノガナシイ	悲	
物悲しさ	モノガナシサ	悲	
物淋しい	モノサビシイ	寂	
物寂しい	モノサビシイ	寂	
物騒がしい	モノサワガシイ	不	
物足りない	モノタリナイ	不	
物足りなさ	モノタリナサ	不	
貰い泣き	モライナキ	悲辛喜	
文句を言う	モンクヲイウ	不	
悶絶	モンゼツ	苦	
悶悶	モンモン	苦	
喧しい	ヤカマシイ	不怒	
やきもき	ヤキモキ	怒	
焼き餅を焼く	ヤキモチヲヤク	妬	
妬く	ヤク	妬	
自棄糞	ヤケクソ	怒	
灼け爛れる	ヤケタダレル	辛苦	
妬ける	ヤケル	妬	
灼ける	ヤケル	辛苦	
安らか	ヤスラカ	安	
安らかさ	ヤスラカサ	安	
安らぎ	ヤスラギ	安	
安らぐ	ヤスラグ	安	
ヤダー	ヤダー	嫌	
やっかい	ヤッカイ	不	
やっかみ	ヤッカミ	不	
やっかむ	ヤッカム	不	
躍起	ヤッキ	怒	
ヤッター	ヤッター	喜	
八つ当たり	ヤツアタリ	怒	
破れかぶれ	ヤブレカブレ	怒	
野暮ったい	ヤボッタイ	不	
疚しい	ヤマシイ	恥	
やむ無い	ヤムナイ	悔	
やむを得ない	ヤムヲエナイ	悔	
ややこしい	ヤヤコシイ	不	
遣り切れない	ヤリキレナイ	悔	
遣る瀬ない	ヤルセナイ	悔	
遣る瀬なさ	ヤルセナサ	悔	
やれやれ	ヤレヤレ	見あ	
友愛	ユウアイ	安親	
憂鬱	ユウウツ	鬱	
憂鬱感	ユウウツカン	鬱	
憂患	ユウカン	悩	
友誼	ユウギ	親	
憂苦	ユウク	鬱苦心	
友好	ユウコウ	親	
憂国	ユウコク	鬱	
憂思	ユウシ	鬱	
憂愁	ユウシュウ	悲鬱	
幽愁	ユウシュウ	鬱	
憂色	ユウショク	ふ心	
憂心	ユウシン	ふ鬱	
友情	ユウジョウ	親	
悠然	ユウゼン	安穏	
悠長	ユウチョウ	安穏	
憂憤	ユウフン	怒鬱	
憂悶	ユウモン	悩苦心	
勇躍	ユウヤク	興	
悠悠	ユウユウ	安穏	
悠悠閑閑	ユウユウカンカン	安穏	
悠揚	ユウヨウ	安穏	
憂慮	ユウリョ	ふ心	
愉悦	ユエツ	喜	
愉快	ユカイ	楽	
揺さ振る	ユサブル	動	
揺す振る	ユスブル	動	
愉楽	ユラク	喜楽	
揺らぐ	ユラグ	動	
揺らめく	ユラメク	動	
ゆらゆら	ユラユラ	穏	
ゆらり	ユラリ	穏	
揺るがす	ユルガス	驚怖	
揺るがない	ユルガナイ	尊	
揺るぎ無い	ユルギナイ	尊	
揺るぐ	ユルグ	鬱	
揺れ	ユレ	鬱	
揺れる	ユレル	動	
好い感情を持つ	ヨイカンジョウヲモツ	好	
好い気持ちがしない	ヨイキモチガシナイ	Ｆ嫌	
好い気持ちはしない	ヨイキモチハシナイ	Ｆ	
好い心持ち	ヨイココロモチ	好気	
好い心持ちはしない	ヨイココロモチワシナイ	Ｆ	
酔う	ヨウ	好	
良かった	ヨカッタ	喜	
好く	ヨク	好	
抑鬱	ヨクウツ	鬱	
欲情	ヨクジョウ	好	
邪	ヨコシマ	嫌不	
横恋慕	ヨコレンボ	好	
慶福	ヨシトミ	祝喜	
好	ヨシミ	好	
よっしゃ	ヨッシャ	喜	
余憤	ヨフン	怒	
喜ばしい	ヨロコバシイ	喜	
喜ばしい訳はない	ヨロコバシイワケワナイ	怒不	
喜ばしさ	ヨロコバシサ	喜	
喜	ヨロコビ	喜	
喜び	ヨロコビ	喜	
喜び狂う	ヨロコビクルウ	喜	
喜ぶ	ヨロコブ	喜	
弱り切る	ヨワリキル	鬱怠	
弱り果てる	ヨワリハテル	鬱怠	
弱る	ヨワル	鬱	
楽	ラク	楽	
落胆	ラクタン	失残	
楽ちん	ラクチン	喜	
落莫	ラクバク	寂	
楽楽	ラクラク	喜	
落涙	ラクルイ	悲辛	
ラッキー	ラッキー	幸喜	
理屈っぽい	リクツッポイ	不	
離愁	リシュウ	悲	
立腹	リップク	怒	
慄然	リツゼン	怖	
溜飲が下がる	リュウインガサガル	安	
良好	リョウコウ	穏	
良心が痛む	リョウシンガイタム	憐辛	
慮外	リョガイ	驚	
旅愁	リョシュウ	鬱	
ルンルン	ルンルン	喜幸	
冷静	レイセイ	安	
恋愛	レンアイ	切好	
恋情	レンジョウ	切好	
廉恥	レンチ	恥	
憐憫	レンビン	憐	
恋慕	レンボ	好	
恋恋	レンレン	悔	
労苦	ロウク	苦辛	
狼狽	ロウバイ	焦	
我がまま	ワガママ	不嫌怒	
沸き返る	ワキカエル	興怒	
沸き立つ	ワキタツ	興	
惑溺	ワクデキ	困	
惑乱	ワクラン	鬱	
わくわく	ワクワク	楽興	
煩い	ワズライ	不	
煩う	ワズラウ	不	
煩わしい	ワズラワシイ	不	
煩わす	ワズラワス	不	
蟠り	ワダカマリ	不嫌	
蟠る	ワダカマル	不嫌	
わっ	ワッ	驚	
戦慄き	ワナナキ	怖	
戦慄く	ワナナク	怖	
わなわな	ワナワナ	怖怒	
詫びしい	ワビシイ	辛ふ	
佗びしい	ワビシイ	辛ふ	
佗びしがる	ワビシガル	辛ふ	
佗びしさ	ワビシサ	辛ふ	
詫びる	ワビル	謝	
笑い	ワライ	楽喜楽	
笑い顔	ワライガオ	楽喜楽	
笑う	ワラウ	楽喜楽	
悪い	ワルイ	嫌	
悪い気がしない	ワルイキガシナイ	楽喜楽	
悪賢い	ワルガシコイ	不嫌	
悪びれる	ワルビレル	恥	
我を忘れる	ワレオワスレル	好	
わぁ	ワー	驚	
わーい	ワーイ	喜	
			
			
			
			
			
			
			
			
			
			
			
			
			
			
			
			
			
			
			
			
