Word	Katakana	Emotion	
哀	アイ	悲	
愛	アイ	好親	
相いれない	アイイレナイ	嫌	
哀感	アイカン	悲寂	
愛敬	アイキョウ	親好	
愛好	アイコウ	好	
哀愁	アイシュウ	悲寂	
愛執	アイシュウ	親好	
哀傷	アイショウ	悲辛	
愛情	アイジョウ	好親	
愛する	アイスル	好親	
哀惜	アイセキ	悲辛	
哀切	アイセツ	悲辛憐	
愛想を尽かす	アイソオツカス	あ失	
愛着	アイチャク	親好	
哀悼	アイトウ	尊寂	
愛慕	アイボ	好親	
愛欲	アイヨク	興親	
愛らしい	アイラシイ	親好	
青息吐息	アオイキトイキ	心辛	
仰ぐ	アオグ	尊	
青筋を立てる	アオスジヲタテル	怒	
赤恥	アカッパジ	恥	
赤らむ	アカラム	恥興	
赤らめる	アカラメル	恥興	
崇める	アガメル	尊	
飽き飽き	アキアキ	不	
飽き足りる	アキタリル	不	
諦め	アキラメ	悔失	
諦める	アキラメル	悔失	
飽きる	アキル	不	
呆れ返る	アキレカエル	あ	
呆れ果てる	アキレハテル	あ失	
呆れる	アキレル	あ	
悪感情	アクカンジョウ	嫌	
倦む	アグム	困あ	
憧れ	アコガレ	喜願興	
憧れる	アコガレル	願	
浅ましい	アサマシイ	見Ｆ	
嘲る	アザケル	見	
味気ない	アジケナイ	不	
焦り	アセリ	焦	
焦る	アセル	焦	
唖然	アゼン	失あ	
頭に来る	アタマニクル	怒	
頭を悩ませる	アタマヲナヤマセル	悩	
当たり散らす	アタリチラス	不怒	
あッ	アッ	驚	
あっけない	アッケナイ	不	
呆気に取られる	アッケニトラレル	驚あ	
圧迫感	アッパクカン	苦Ｆ	
熱い	アツイ	驚興	
熱いものがこみ上げる	アツイモノガコミアゲル	喜切苦興	
厚かましい	アツカマシイ	Ｆ	
熱くなる	アツクナル	興	
暑苦しい	アツクルシイ	苦Ｆ	
後味が良くない	アトアジガヨクナイ	き困Ｆ	
後味が宜しくない	アトアジガヨロシクナイ	き困Ｆ	
後味が悪い	アトアジガワルイ	き困Ｆ	
侮る	アナドル	見	
阿鼻叫喚	アビキョウカン	苦辛痛困	
危ない	アブナイ	驚心	
あほらしい	アホラシイ	あ憐	
荒々しい	アラアラシイ	興	
あらッ	アラッ	驚	
ありがたい	アリガタイ	感	
ありがたみ	アリガタミ	感	
ありがた迷惑	アリガタメイワク	困Ｆ	
ありがと	アリガト	感	
ありがとう	アリガトウ	感	
ありゃ	アリャ	驚困	
慌てふためく	アワテフタメク	驚焦困	
慌てる	アワテル	驚焦	
哀れ	アワレ	憐	
憐れ	アワレ	憐	
憐れみ	アワレミ	憐	
憐れむ	アワレム	憐	
安逸	アンイツ	楽	
暗鬱	アンウツ	鬱Ｆ	
安閑	アンカン	安	
案外	アンガイ	驚	
安心	アンシン	安	
案ずる	アンズル	心ふ	
暗然	アンゼン	鬱	
安息感	アンソクカン	安	
暗澹	アンタン	ふ鬱	
安定	アンテイ	穏	
安堵	アンド	安喜	
安寧	アンネイ	安	
安楽	アンラク	安	
怡怡	イイ	喜楽	
言い寄る	イイヨル	願	
いかがわしい	イカガワシイ	興願	
厳つい	イカツイ	Ｆ	
怒らす	イカラス	怒	
怒り	イカリ	怒	
怒りが爆発する	イカリガバクハツスル	怒興	
怒り狂う	イカリクルウ	怒興	
遺憾	イカン	失悔情残	
意外	イガイ	驚	
啀み合う	イガミアウ	嫌	
啀む	イガム	嫌	
息を詰める	イキオツメル	緊ふ	
息が詰まる	イキガツマル	緊ふ	
息苦しい	イキグルシイ	苦	
息苦しさ	イキグルシサ	苦	
意気軒昂	イキケンコウ	願興	
意気消沈	イキショウチン	残失	
憤り	イキドオリ	怒不	
憤る	イキドオル	怒不	
行き悩む	イキナヤム	困辛鬱	
生き恥	イキハジ	恥	
息巻く	イキマク	怒興	
熱り立つ	イキリタツ	怒興	
息を飲む	イキヲノム	動驚気	
息を潜める	イキヲヒソメル	緊ふ	
いけ好かない	イケスカナイ	嫌不Ｆ	
いけ図々しい	イケズウズウシイ	見Ｆ	
依怙地になる	イコジニナル	た	
遺恨	イコン	恨不残	
勇ましい	イサマシイ	気興	
意趣	イシュ	恨	
萎縮	イシュク	怖ふ	
意地汚い	イジキタナイ	見嫌Ｆ	
意地悪	イジワル	見嫌Ｆ	
いそいそ	イソイソ	喜	
意想外	イソウガイ	驚	
痛い	イタイ	辛苦	
痛々しい	イタイタシイ	辛苦残	
居た堪れない	イタタマレナイ	き	
痛ましい	イタマシイ	辛苦残	
痛み	イタミ	辛苦	
痛み入る	イタミイル	恐あ	
悼む	イタム	尊悲寂	
痛める	イタメル	辛苦	
いちゃもんを付ける	イチャモンヲツケル	願	
一憂	イチユウ	鬱	
一喜	イッキ	喜	
一驚	イッキョウ	驚	
慈しみ	イツクシミ	親好安	
慈しむ	イツクシム	親好安	
逸楽	イツラク	楽	
厭う	イトウ	嫌尊	
愛おしい	イトオシイ	尊親好	
愛おしむ	イトオシム	尊親好	
愛しい	イトシイ	尊親好	
愛しがる	イトシガル	親好	
愛しさ	イトシサ	尊親好	
厭わしい	イトワシイ	嫌見	
厭わしさ	イトワシサ	嫌見	
畏怖	イフ	恐	
忌忌しい	イマイマシイ	嫌Ｆ	
忌忌しがる	イマイマシガル	嫌Ｆ	
忌まわしい	イマワシイ	嫌失Ｆ	
忌み嫌う	イミキラウ	嫌Ｆ	
忌む	イム	嫌Ｆ	
嫌	イヤ	嫌	
厭	イヤ	嫌	
厭厭	イヤイヤ	不嫌	
厭がる	イヤガル	嫌Ｆ	
嫌気	イヤケ	不Ｆ	
卑しい	イヤシイ	見嫌	
卑しむ	イヤシム	見	
嫌味	イヤミ	嫌見Ｆ	
厭らしい	イヤラシイ	嫌	
苛苛しい	イライラシイ	不Ｆ	
苛苛する	イライラスル	不Ｆ	
苛立たしい	イラダタシイ	不Ｆ	
苛立たしさ	イラダタシサ	不Ｆ	
苛立ち	イラダチ	不Ｆ	
苛立つ	イラダツ	不Ｆ	
苛立てる	イラダテル	不Ｆ	
色を失う	イロヲウシナウ	心怖	
色をなす	イロヲナス	怒	
陰鬱	インウツ	鬱不Ｆ	
陰気	インキ	鬱不	
陰気臭い	インキクサイ	嫌Ｆ	
陰惨	インサン	怖	
陰湿	インシツ	不Ｆ	
浮かされる	ウカサレル	興	
浮かぬ顔	ウカヌカオ	ふ鬱	
浮かれる	ウカレル	楽興幸	
浮き足立つ	ウキアシタツ	怖ふ緊	
うきうきする	ウキウキスル	楽喜幸	
浮き立つ	ウキタツ	楽興幸	
憂き目	ウキメ	辛悲が	
憂さ	ウサ	鬱	
胡散臭い	ウサンクサイ	嫌	
後ろめたい	ウシロメタイ	き	
後ろめたさ	ウシロメタサ	き	
薄気味悪い	ウスキミワルイ	ふ	
薄汚い	ウスギタナイ	見Ｆ	
うずうず	ウズウズ	興	
打ち萎れる	ウチシオレル	情	
打ち拉がれる	ウチヒシガレル	情	
有頂天	ウチョウテン	喜興	
鬱気	ウッキ	鬱	
鬱屈	ウックツ	鬱	
鬱散	ウッサン	楽	
鬱積	ウッセキ	不	
鬱陶しい	ウットウシイ	嫌Ｆ鬱	
鬱陶しさ	ウットウシサ	嫌Ｆ鬱	
うっとり	ウットリ	幸動	
鬱憤	ウップン	怒恨不	
鬱	ウツ	鬱	
鬱鬱と	ウツウツト	鬱	
俯き	ウツムキ	ふ情心	
俯く	ウツムク	情	
鬱悶	ウツモン	苦鬱	
虚	ウツロ	失情	
疎ましい	ウトマシイ	嫌Ｆ	
疎む	ウトム	嫌Ｆ	
疎んじる	ウトンジル	嫌Ｆ	
疎んずる	ウトンズル	嫌Ｆ	
美味い	ウマイ	喜好幸	
旨い	ウマイ	喜好幸	
上手い	ウマイ	喜尊	
呻き声	ウメキゴエ	苦	
呻く	ウメク	苦	
敬う	ウヤマウ	尊	
うら悲しい	ウラガナシイ	悲	
うら淋しい	ウラサビシイ	寂	
うら寂しい	ウラサビシイ	寂	
恨み	ウラミ	恨Ｆ	
恨みがましい	ウラミガマシイ	恨Ｆ	
恨む	ウラム	恨Ｆ	
恨めしい	ウラメシイ	恨Ｆ	
恨めしがる	ウラメシガル	恨Ｆ	
恨めしく思う	ウラメシクオモウ	恨Ｆ	
羨ましい	ウラヤマシイ	願	
羨ましがる	ウラヤマシガル	願	
羨む	ウラヤム	願	
五月蝿い	ウルサイ	Ｆ嫌	
麗しい	ウルワシイ	動	
憂い	ウレイ	鬱辛苦切	
愁い	ウレイ	ふ心	
愁え	ウレイ	ふ心	
憂える	ウレエル	ふ心	
嬉しい	ウレシイ	喜幸	
嬉しかった	ウレシカッタ	喜幸	
嬉しがらせ	ウレシガラセ	喜幸	
嬉しがらせる	ウレシガラセル	喜幸	
嬉しがる	ウレシガル	喜幸	
嬉しさ	ウレシサ	喜幸	
嬉し泣き	ウレシナキ	喜幸	
嬉し涙	ウレシナミダ	喜幸	
嬉しみ	ウレシミ	喜幸	
憂わしい	ウレワシイ	情	
狼狽える	ウロタエル	驚困	
上擦る	ウワズル	興焦	
うんざり	ウンザリ	嫌Ｆ	
詠嘆	エイタン	動	
笑顔	エガオ	喜楽幸	
依怙贔屓	エコヒイキ	嫌Ｆ不	
えッ	エッ	驚あ	
悦	エツ	喜	
笑壺に入る	エツボニハイル	喜	
悦楽	エツラク	喜楽	
恵比寿顔	エビスガオ	幸	
笑み	エミ	喜楽幸	
笑む	エム	喜楽幸	
厭悪	エンオ	嫌	
怨恨	エンコン	恨	
怨嗟	エンサ	恨	
怨色	エンショク	恨	
えーっ	エーッ	驚あ	
おいおい	オイオイ	悲あ	
美味しい	オイシイ	幸喜	
謳歌	オウカ	幸	
嘔吐	オウト	苦嫌Ｆ	
懊悩	オウノウ	悩	
大恥	オウハジ	恥	
大喜び	オウヨロコビ	喜	
嗚咽	オエツ	悲辛	
おぉ	オォ	動驚	
おお	オオ	動驚	
男男しい	オオシイ	誇	
岡惚れ	オカボレ	好切	
岡焼き	オカヤキ	不ふ妬	
御気に入り	オキニイリ	好	
お気に入り	オキニハイリ	好	
臆する	オクスル	た怖	
臆病	オクビョウ	怖	
臆面	オクメン	怖	
臆面もなく	オクメンモナク	Ｆ	
怒らせる	オコラセル	怒	
怒り出す	オコリダス	怒	
怒り付ける	オコリツケル	怒	
怒る	オコル	怒	
惜しい	オシイ	切不	
惜しがる	オシガル	残	
惜し気	オシゲ	残	
押し付けがましい	オシツケガマシイ	嫌Ｆ	
惜しむ	オシム	切不	
怖気付く	オジケツク	怖	
汚辱	オジョク	見	
恐る恐る	オソルオソル	怖	
恐れ	オソレ	怖	
恐れ入る	オソレイル	尊謝	
恐れ多い	オソレオオイ	感謝	
恐れる	オソレル	ふ怖	
恐ろしい	オソロシイ	ふ怖	
恐ろしがる	オソロシガル	ふ怖	
恐ろしさ	オソロシサ	ふ怖	
おぞましい	オゾマシイ	嫌Ｆ	
落ち着かない	オチツカナイ	ふ心	
落ち着き	オチツキ	安	
落ち着き払う	オチツキハラウ	安	
落ち着く	オチツク	安	
落ち着ける	オチツケル	安	
おっ	オッ	驚	
おっかない	オッカナイ	怖	
躍り上がる	オドリアガル	喜驚	
おどろおどろしい	オドロオドロシイ	怖嫌Ｆ	
驚かす	オドロカス	驚	
驚き	オドロキ	驚	
驚き呆れる	オドロキアキレル	驚あ	
驚き入る	オドロキイル	驚	
驚く	オドロク	驚	
戦き	オノノキ	怖	
戦く	オノノク	怖興	
怯え	オビエ	怖	
怯え切る	オビエキル	怖	
怯える	オビエル	怖	
思し召す	オボシメス	尊	
溺れる	オボレル	苦辛興願	
怖めず臆せず	オメズオクセズ	誇	
おめでたい	オメデタイ	祝	
おめでとう	オメデトウ	祝	
おもいがけない	オモイガケナイ	驚	
思い屈する	オモイクッスル	鬱	
思い焦がれる	オモイコガレル	切苦鬱	
思い詰める	オモイツメル	ふ悩	
思い悩む	オモイナヤム	ふ悩	
思い残す	オモイノコス	願不	
思いの外	オモイノホカ	驚	
思い惑う	オモイマドウ	悩	
思い迷う	オモイマヨウ	悩	
思いも寄らず	オモイモヨラズ	驚	
思いも寄らない	オモイモヨラナイ	驚	
思いも寄らぬ	オモイモヨラヌ	驚	
思い遣り	オモイヤリ	親好	
思い遣る	オモイヤル	親好	
思い煩う	オモイワズラウ	悩苦	
重苦しい	オモクルシイ	苦	
重苦しさ	オモクルシサ	苦	
面白い	オモシロイ	幸楽	
面白かった	オモシロカッタ	幸楽	
面白がる	オモシロガル	幸楽	
面白くない	オモシロクナイ	不	
面憎い	オモニクイ	憎	
重荷を下ろす	オモニヲオロス	安気	
面映い	オモハユイ	恥	
おもろい	オモロイ	楽幸	
重んじる	オモンジル	尊	
親心	オヤゴコロ	心	
おろおろ	オロオロ	焦心	
愚か	オロカ	失情あ	
おろかしい	オロカシイ	失情あ	
愚かしい	オロカシイ	失情あ	
恩愛	オンアイ	情親好	
恩寵	オンチョウ	尊感	
怨念	オンネン	恨	
快感	カイカン	安気	
怪奇	カイキ	嫌Ｆ	
懐旧	カイキュウ	親寂安	
懐郷	カイキョウ	寂安	
懐古	カイコ	親寂安	
悔恨	カイコン	悔不	
悔悟	カイゴ	悔情	
快哉	カイサイ	気	
快楽	カイラク	幸楽気	
顔を赤らめる	カオオアカラメル	恥	
顔を隠す	カオオカクス	恥	
顔を曇らせる	カオオクモラセル	ふ悩	
顔をしかめる	カオオシカメル	不Ｆ	
顔から火が出る	カオカラヒガデル	恥	
顔が火照る	カオガホテル	恥	
掻き暗れる	カキクレル	悲	
掻き毟られる	カキムシラレル	ふＦ	
隔意	カクイ	た	
鶴首	カクシュ	願	
嚇怒	カクド	怒	
かぐわしい	カグワシイ	尊	
陰る	カゲル	ふ	
風向きが悪い	カザムキガワルイ	ふ	
畏まる	カシコマル	恐	
呵責	カシャク	苦	
片恨み	カタウラミ	恨	
肩を落とす	カタオオトス	悲	
片想い	カタオモイ	好切鬱	
固くなる	カタクナル	緊	
堅苦しい	カタクルシイ	不	
かたじけない	カタジケナイ	謝	
肩の荷が下りる	カタノニガオリル	安	
片腹痛い	カタハライタイ	見	
肩身が狭い	カタミガセマイ	き	
肩身が広い	カタミガヒロイ	誇	
かちっと来る	カチットクル	怒	
勝ち誇る	カチホコル	誇	
隔靴掻痒	カッカソウヨウ	不	
かったるい	カッタルイ	不	
渇望	カツボウ	願	
哀しい	カナシイ	悲辛切	
悲しい	カナシイ	悲辛切	
悲しがる	カナシガル	悲辛切	
悲しさ	カナシサ	悲辛切	
哀しさ	カナシサ	悲辛切	
悲しまれる	カナシマレル	悲辛切	
悲しみ	カナシミ	悲辛切	
悲しむ	カナシム	悲辛切	
叶わない	カナワナイ	悲失	
雷に打たれる	カミナリニウタレル	驚	
絡む	カラム	嫌Ｆ	
軽がろしい	カロガロシイ	見	
軽んじる	カロンジル	見	
軽んずる	カロンズル	見	
可愛がる	カワイガル	好親	
可哀想	カワイソウ	憐	
奸悪	カンアク	Ｆ	
感悦	カンエツ	喜	
感慨	カンガイ	動	
感慨無量	カンガイムリョウ	動	
汗顔	カンガン	恥	
歓喜	カンキ	喜	
感泣	カンキュウ	動	
感興	カンキョウ	親	
感極まる	カンキワマル	動	
艱苦	カンク	悩苦	
感激	カンゲキ	動	
歓呼	カンコ	喜	
感謝	カンシャ	感	
癇癪	カンシャク	怒	
感傷	カンショウ	切	
歓笑	カンショウ	喜	
歓心	カンシン	喜	
寒心	カンシン	怖	
感心	カンシン	尊	
莞爾	カンジ	喜幸	
感じ入る	カンジイル	尊誇	
感情的	カンジョウテキ	興	
感情を害する	カンジョウヲガイスル	Ｆ	
感情を昂らせる	カンジョウヲタカブラセル	興	
歓声	カンセイ	喜	
感嘆	カンタン	尊誇悲	
歓天喜地	カンテンキチ	喜	
感動	カンドウ	動	
感に堪える	カンニコタエル	動	
癇に障る	カンニサワル	嫌	
感に堪えない	カンニタエナイ	動	
勘忍袋の緒が切れる	カンニンブクロノオガキレル	怒	
感服	カンプク	動	
感無量	カンムリョウ	動	
感銘	カンメイ	動	
寛容	カンヨウ	穏	
歓楽	カンラク	喜楽	
感涙	カンルイ	感	
歓を尽くす	カンヲツクス	楽	
賀意	ガイ	祝	
慨然	ガイゼン	鬱	
慨嘆	ガイタン	鬱	
愕然	ガクゼン	驚	
がっかり	ガッカリ	残	
がっくり	ガックリ	残	
我慢ならない	ガマンナラナイ	怒興	
がみがみ	ガミガミ	怒	
がめつい	ガメツイ	嫌	
気鬱	キウツ	不鬱	
消え入りたい	キエイリタイ	恥悲	
喜悦	キエツ	喜	
気後れ	キオクレ	怖恥	
気落ち	キオチ	残失	
気を揉む	キオモム	心	
気を悪くする	キオワルクスル	嫌Ｆ	
気がある	キガアル	好	
気が置かれる	キガオカレル	き	
気が重い	キガオモイ	ふ鬱苦	
気懸かり	キガカリ	心	
気が軽い	キガカルイ	気	
気が気でない	キガキデナイ	ふ鬱心	
気が沈む	キガシズム	鬱	
気が急く	キガセク	焦	
気が立つ	キガタツ	興	
気が咎める	キガトガメル	情た	
気兼ね	キガネ	心恐	
気が引き締まる	キガヒキシマル	緊	
気が参る	キガマイル	辛	
気が滅入る	キガメイル	鬱	
気が揉める	キガモメル	心	
気が緩む	キガユルム	安	
気が楽	キガラク	安	
気軽	キガル	親	
気軽い	キガルイ	親	
嬉嬉	キキ	幸喜楽	
聞き苦しい	キキグルシイ	困Ｆ	
聞き捨てならない	キキズテナラナイ	不Ｆ	
聞き辛い	キキズライ	困Ｆ	
聞きにくい	キキニクイ	困	
危懼	キク	ふ	
危惧	キグ	ふ	
気苦労	キグロウ	辛苦	
危険	キケン	ふ	
機嫌好い	キゲンヨイ	幸	
きざっぽい	キザッポイ	嫌Ｆ	
気障り	キザワリ	嫌Ｆ	
キショい	キショイ	嫌Ｆ	
喜色	キショク	喜	
気色が悪い	キショクガワルイ	嫌Ｆ	
気色を害する	キショクヲガイスル	Ｆ	
気色を悪くする	キショクヲワルクスル	Ｆ	
傷痕	キズアト	辛切誇	
気遣い	キズカイ	心	
気遣う	キズカウ	心	
気遣わしい	キズカワシイ	心	
傷付く	キズツク	辛	
気忙しい	キゼワシイ	ふ	
気忙しさ	キゼワシサ	ふ	
汚い	キタナイ	嫌Ｆ	
汚らしい	キタナラシイ	嫌Ｆ	
狐に撮まれたよう	キツネニツママレタヨウ	驚	
気詰まり	キヅマリ	き	
気に入る	キニイル	好	
気に食わない	キニクワナイ	嫌Ｆ	
気に障る	キニサワル	嫌Ｆ	
気になる	キニナル	困	
気に入らない	キニハイラナイ	嫌	
気に病む	キニヤム	心悩	
気抜け	キヌケ	穏	
気の毒	キノドク	心	
気恥ずかしい	キハズカシイ	恥き	
気恥ずかしさ	キハズカシサ	恥き	
厳しい	キビシイ	辛	
気塞ぎ	キフサギ	鬱	
気分が和む	キブンガナゴム	安	
気分が弾む	キブンガハズム	幸喜	
気まずい	キマズイ	き	
気まずさ	キマズサ	き	
きまりが悪い	キマリガワルイ	恥き	
気味が悪い	キミガワルイ	怖Ｆ	
気味悪い	キミワルイ	怖Ｆ	
気味悪さ	キミワルサ	怖Ｆ	
気持ちいい	キモチイイ	気	
気持ちが傷付けられる	キモチガキズツケラレル	辛	
気持ちが沈む	キモチガシズム	悲	
気持ちが和む	キモチガナゴム	安	
気持ちが晴れる	キモチガハレル	気	
気持ちが晴れ渡る	キモチガハレワタル	幸気	
気持ちが好い	キモチガヨイ	喜気幸	
気持ちが悪くなる	キモチガワルクナル	Ｆ	
気持ちの好いものではない	キモチノヨイモノデワナイ	嫌Ｆ	
気持ちよい	キモチヨイ	気	
気持ち良い	キモチヨイ	気	
気持ち悪い	キモチワルイ	Ｆ	
肝を潰す	キモヲツブス	驚	
肝を冷やす	キモヲヒヤス	怖驚	
きゃあ	キャア	驚怖	
キャッ	キャッ	驚怖	
気安い	キヤスイ	安親	
窮屈	キュウクツ	辛	
窮する	キュウスル	苦	
杞憂	キユウ	心鬱	
驚異	キョウイ	驚	
恐悦	キョウエツ	喜感	
恭賀	キョウガ	祝	
驚愕	キョウガク	驚	
驚懼	キョウガク	驚怖	
興が醒める	キョウガサメル	失Ｆ	
興がる	キョウガル	楽	
狂喜	キョウキ	喜	
驚喜	キョウキ	喜	
恟恟	キョウキョウ	怖	
恐懼	キョウク	恐	
恐慌	キョウコウ	怖焦	
興醒め	キョウザメ	失不	
興趣	キョウシュ	楽	
郷愁	キョウシュウ	切苦寂	
恐縮	キョウシュク	怖恐	
興じる	キョウジル	楽	
驚嘆	キョウタン	驚尊	
驚天動地	キョウテンドウチ	驚	
驚倒	キョウトウ	驚	
恐怖	キョウフ	怖	
驚怖	キョウフ	怖驚	
恐怖感	キョウフカン	怖	
凶暴	キョウボウ	怖	
興味深い	キョウミブカイ	願	
享楽	キョウラク	幸楽気	
狂恋	キョウレン	興切苦願	
虚心坦懐	キョシンタンカイ	穏	
虚脱感	キョダツカン	鬱失	
きょときょと	キョトキョト	ふ	
きょとんとする	キョトントスル	穏	
虚無	キョム	穏	
嫌い	キライ	嫌	
嫌う	キラウ	嫌	
気楽	キラク	安楽	
気を腐らせる	キヲクサラセル	嫌不	
気を呑まれる	キヲノマレル	恐	
欣快	キンカイ	気喜	
欣喜	キンキ	喜	
欣喜雀躍	キンキジャクヤク	喜	
欣欣	キンキン	喜	
欣幸	キンコウ	喜幸	
欣然	キンゼン	喜楽	
緊張	キンチョウ	緊	
緊張感	キンチョウカン	緊	
緊張がほどける	キンチョウガホドケル	安	
緊迫	キンパク	緊	
欣慕	キンボ	喜尊	
欣躍	キンヤク	喜	
疑懼	ギク	怖	
ぎくっ	ギクッ	驚	
ぎくり	ギクリ	驚	
ぎっくり	ギックリ	驚	
義憤	ギフン	怒Ｆ	
ぎゃあ	ギャア	驚苦	
逆上	ギャクジョウ	怒興	
仰天	ギョウテン	驚	
御慶	ギョケイ	祝	
ぎょっとする	ギョットスル	驚	
苦	ク	苦	
悔い	クイ	悔	
悔いる	クイル	悔残	
空虚	クウキョ	穏	
臭い	クサイ	嫌Ｆ	
腐る	クサル	鬱	
くしゃくしゃな顔	クシャクシャナカオ	悲	
苦笑	クショウ	不Ｆ	
苦渋	クジュウ	苦辛	
くすくす	クスクス	楽	
くすぐったい	クスグッタイ	恥	
くだらない	クダラナイ	あ見情	
口煩い	クチウルサイ	嫌Ｆ	
口惜しい	クチオシイ	悔	
くちぎたない	クチギタナイ	嫌Ｆ	
唇を噛む	クチビルオカム	悔不	
くちやかましい	クチヤカマシイ	嫌Ｆ	
苦衷	クチュウ	苦辛	
喰って掛かる	クッテカカル	興	
苦痛	クツウ	苦辛痛	
屈辱	クツジョク	恥辛	
屈辱感	クツジョクカン	恥辛	
寛ぎ	クツロギ	安	
寛ぐ	クツログ	安	
寛げる	クツロゲル	安	
くどい	クドイ	嫌Ｆ	
苦悩	クノウ	悩苦	
首っ丈	クビッタケ	興楽親	
首をすくめる	クビヲスクメル	ふ怖	
曇る	クモル	鬱	
苦悶	クモン	苦鬱	
悔しい	クヤシイ	悔	
悔しがる	クヤシガル	悔	
悔しさ	クヤシサ	悔	
悔し泣き	クヤシナキ	悔	
悔し涙	クヤシナミダ	悔	
悔み	クヤミ	悔	
悔む	クヤム	悔	
くよくよ	クヨクヨ	心	
暗い	クライ	鬱	
狂い怒る	クルイオコル	怒	
苦しい	クルシイ	苦	
苦しさ	クルシサ	苦	
苦しみ	クルシミ	苦	
苦しみ悶える	クルシミモダエル	苦	
苦しむ	クルシム	苦	
苦労	クロウ	苦	
具合が悪い	グアイガワルイ	辛苦	
具合悪い	グアイワルイ	辛苦	
愚図愚図	グズグズ	不	
愚図る	グズル	不	
ぐっと来る	グットクル	動	
敬愛	ケイアイ	尊親	
慶賀	ケイガ	喜	
慶祝	ケイシュク	喜	
慶する	ケイスル	喜	
傾倒	ケイトウ	尊	
敬服	ケイフク	尊	
敬慕	ケイボ	尊	
気圧される	ケオサレル	恐	
汚らわしい	ケガラワシイ	嫌Ｆ	
毛嫌い	ケギライ	嫌	
気色ばむ	ケシキバム	怒	
懸想	ケソウ	好親	
気怠い	ケダルイ	怠	
血相を変える	ケッソウヲカエル	怒	
血涙	ケツルイ	悲怒	
懸念	ケネン	心ふ	
けばけばしい	ケバケバシイ	嫌Ｆ	
煙い	ケムイ	苦Ｆ	
煙たい	ケムタイ	苦Ｆ	
けろっ	ケロッ	穏	
けろり	ケロリ	穏	
慊焉	ケンエン	不	
倦厭	ケンエン	不	
嫌悪	ケンオ	嫌憎	
嫌悪感	ケンオカン	嫌憎	
嫌忌	ケンキ	嫌Ｆ	
倦怠	ケンタイ	不	
倦怠感	ケンタイカン	怠	
権幕	ケンマク	興	
激越	ゲキエツ	興	
激語	ゲキゴ	興	
激賞	ゲキショウ	喜	
激情	ゲキジョウ	興	
激する	ゲキスル	興	
激怒	ゲキド	怒	
激憤	ゲキフン	怒不	
逆鱗に触れる	ゲキリンニフレル	怒	
げっ	ゲッ	驚困	
激昂	ゲッコウ	怒興	
げっそり	ゲッソリ	辛苦	
下品	ゲヒン	嫌Ｆ	
下劣	ゲレツ	嫌Ｆ	
元気	ゲンキ	気	
減退	ゲンタイ	辛苦	
げんなり	ゲンナリ	不嫌	
幻滅	ゲンメツ	失	
恋	コイ	好幸切鬱	
恋い焦がれる	コイコガレル	好切鬱苦	
恋心	コイゴコロ	好幸切鬱	
恋しい	コイシイ	好切鬱	
恋しさ	コイシサ	好切鬱	
恋する	コイスル	好幸切鬱	
冀う	コイネガウ	願	
恋う	コウ	好幸切鬱	
厚意	コウイ	親	
好意	コウイ	好親	
光栄	コウエイ	誇	
厚恩	コウオン	感	
後悔	コウカイ	悔	
交歓	コウカン	楽親	
好感	コウカン	好	
慷慨	コウガイ	辛苦	
好機	コウキ	喜	
耿耿	コウコウ	ふ鬱	
恍惚	コウコツ	喜幸興	
恍惚感	コウコツカン	喜幸興	
厚志	コウシ	親	
昂進	コウシン	興	
厚情	コウジョウ	親	
困じる	コウジル	困	
困ずる	コウズル	困	
昂然	コウゼン	興	
浩然	コウゼン	安	
紅潮	コウチョウ	恥喜	
幸福	コウフク	幸	
幸福感	コウフクカン	幸	
公憤	コウフン	怒不	
興奮	コウフン	興	
昂揚	コウヨウ	興	
荒涼	コウリョウ	寂	
紅涙	コウルイ	悲	
小煩い	コウルサイ	嫌Ｆ	
声を荒立てる	コエオアラダテル	怒興	
声が潤む	コエガウルム	悲	
小躍り	コオドリ	喜	
焦がれる	コガレル	願	
小汚い	コギタナイ	嫌Ｆ	
酷悪	コクアク	嫌Ｆ	
焦げ臭い	コゲクサイ	嫌Ｆ	
心地良い	ココチヨイ	安	
心地良さ	ココチヨサ	安	
心憂い	ココロウレイ	鬱	
心後れ	ココロオクレ	怖ふ	
心悲しい	ココロカナシイ	悲	
心悲しさ	ココロカナシサ	悲	
心が痛む	ココロガイタム	苦	
心が動かされる	ココロガウゴカサレル	動	
心が重い	ココロガオモイ	辛	
心懸かり	ココロガカリ	心	
心が傷付く	ココロガキズツク	辛悲	
心が傷付けられる	ココロガキズツケラレル	辛悲	
心が弾む	ココロガハズム	幸喜	
心が張り詰める	ココロガハリツメル	緊	
心が細る	ココロガホソル	辛	
心苦しい	ココログルシイ	情心	
心苦しさ	ココログルシサ	情心	
心淋しい	ココロサビシイ	寂	
心遣い	ココロズカイ	感	
心強い	ココロズヨイ	安	
心憎い	ココロニクイ	尊	
心の痛み	ココロノイタミ	辛	
心の傷	ココロノキズ	辛	
心残り	ココロノコリ	心不残	
心細い	ココロボソイ	ふ心	
心細さ	ココロボソサ	ふ心	
心持ちが好くない	ココロモチガヨクナイ	Ｆ不ふ	
心持ちが悪い	ココロモチガワルイ	Ｆ不ふ	
心許ない	ココロモトナイ	ふ	
心安い	ココロヤスイ	安	
心行く	ココロユク	気	
快い	ココロヨイ	気	
快く思わない	ココロヨクオモワナイ	Ｆ嫌不	
心を奪われる	ココロヲウバワレル	興	
心を砕く	ココロヲクダク	苦心	
心を遣る	ココロヲヤル	寂鬱	
小淋しい	コサビシイ	寂	
小賢しい	コザカシイ	嫌	
腰を抜かす	コシオヌカス	驚	
小癪	コシャク	見	
小突かれる	コズカレル	嫌	
姑息	コソク	嫌	
こそばゆい	コソバユイ	恥	
小面憎い	コヅラニクイ	憎	
孤独	コドク	寂	
孤独感	コドクカン	寂	
小憎らしい	コニクラシイ	憎見	
好ましい	コノマシイ	好	
好ましさ	コノマシサ	好	
好まない	コノマナイ	嫌	
好み	コノミ	好	
好む	コノム	好	
困り切る	コマリキル	困	
困り抜く	コマリヌク	困	
困り果てる	コマリハテル	困	
困る	コマル	困	
小難しい	コムズカシイ	鬱	
小やかましい	コヤカマシイ	嫌	
こらぁ	コラァ	怒	
懲り懲り	コリゴリ	謝	
怖	コワ	怖	
怖い	コワイ	怖	
恐い	コワイ	怖	
怖がる	コワガル	怖	
怖怖	コワゴワ	怖	
恐恐	コワゴワ	怖	
怖さ	コワサ	怖	
強張る	コワバル	緊怖	
困却	コンキャク	困	
困窮	コンキュウ	苦	
困苦	コンク	困苦	
困惑	コンワク	困	
合歓	ゴウカン	喜	
号泣	ゴウキュウ	悲辛	
号哭	ゴウコク	悲辛	
業腹	ゴウハラ	怒	
強欲	ゴウヨク	嫌	
業を煮やす	ゴウヲニヤス	怒	
御機嫌	ゴキゲン	幸喜	
ゴメン	ゴメン	謝	
最愛	サイアイ	好	
最悪	サイアク	嫌	
再燃	サイネン	興	
幸い	サイワイ	幸	
逆恨み	サカウラミ	恨	
蔑む	サゲスム	見	
差出がましい	サシデシガマシイ	恐	
殺気立つ	サッキタツ	嫌怒興	
さっぱり	サッパリ	気	
さばさば	サバサバ	気	
寂しい	サビシイ	寂	
淋しい	サビシイ	寂	
淋しがる	サビシガル	寂	
淋しさ	サビシサ	寂	
寒気	サムケ	Ｆ辛	
寒寒	サムザム	寂悲	
さめざめ	サメザメ	悲	
冷める	サメル	不	
騒がしい	サワガシイ	Ｆ	
騒ぎ立つ	サワギタツ	Ｆ	
爽やか	サワヤカ	気	
鑽仰	サンギョウ	尊	
讃嘆	サンタン	尊	
三拝九拝	サンパイキュウハイ	尊願	
慚愧	ザンキ	恥	
残念	ザンネン	残	
幸せ	シアワセ	幸	
私怨	シエン	恨	
しおしお	シオシオ	悲残	
しかめっ面	シカメッツラ	不	
しかめる	シカメル	Ｆ不	
叱り付ける	シカリツケル	怒心	
叱り飛ばす	シカリトバス	怒心	
叱る	シカル	怒心	
しくしく	シクシク	悲辛	
四苦八苦	シクハック	苦	
嗜好	シコウ	好	
至情	シジョウ	尊好	
静まる	シズマル	安	
沈み込む	シズミコム	鬱悲	
沈む	シズム	辛が	
慕い寄る	シタイヨル	親尊	
慕う	シタウ	好焦尊	
舌打ち	シタウチ	Ｆ嫌	
親しみ	シタシミ	親	
親しむ	シタシム	親	
したり顔	シタリガオ	誇	
慕わしい	シタワシイ	好親	
七面倒臭い	シチメンドウクサイ	嫌	
嫉視	シッシ	妬	
叱責	シッセキ	怒	
叱咤	シッタ	怒願	
失墜感	シッツイカン	悲失	
嫉妬	シット	妬	
失意	シツイ	失情	
しつこい	シツコイ	嫌	
失望	シツボウ	失	
失望感	シツボウカン	失	
失恋	シツレン	悲辛失	
忍び泣き	シノビナキ	悲辛	
忍び泣く	シノビナク	悲辛	
偲ぶ	シノブ	寂切親	
痺れる	シビレル	動	
私憤	シフン	怒不	
渋る	シブル	た	
思慕	シボ	好尊	
湿っぽい	シメッポイ	鬱	
湿っぽさ	シメッポサ	鬱	
湿る	シメル	鬱	
謝意	シャイ	謝	
癪	シャク	不Ｆ	
癪に障る	シャクニサワル	Ｆ	
しゃくり上げる	シャクリアゲル	辛悲	
しゃくり泣き	シャクリナキ	辛悲	
醜悪	シュウアク	嫌	
秋思	シュウシ	寂	
愁思	シュウシ	悲	
愁傷	シュウショウ	悲	
周章	シュウショウ	焦	
周章狼狽	シュウショウロウバイ	焦	
愁色	シュウショク	鬱	
愁然	シュウゼン	鬱	
愁訴	シュウソ	苦悲	
愁嘆	シュウタン	鬱悲	
羞恥	シュウチ	恥	
羞恥心	シュウチシン	恥	
祝着	シュウチャク	祝喜	
愁眉	シュウビ	心鬱	
愁眉を開く	シュウビヲヒラク	安	
秋風落莫	シュウフウラクバク	寂	
祝意	シュクイ	祝喜	
宿怨	シュクエン	恨	
祝賀	シュクガ	祝喜	
祝する	シュクスル	祝	
朱を注ぐ	シュヲソソグ	恥怒	
春愁	シュンシュウ	悲寂	
鍾愛	ショウアイ	好尊	
憧憬	ショウケイ	願尊	
衝撃	ショウゲキ	驚	
悄悄	ショウショウ	悲	
悄悄と	ショウショウト	悲	
傷心	ショウシン	悲辛	
焦心	ショウシン	悩不	
憔悴	ショウスイ	辛苦	
悚然	ショウゼン	怖ふ	
悄然	ショウゼン	寂悲	
焦躁	ショウソウ	不焦	
賞嘆	ショウタン	尊	
悄沈	ショウチン	悲	
焦慮	ショウリョ	焦不	
性悪	ショウワル	嫌	
食指を動かす	ショクシオウゴカス	好	
食傷	ショクショウ	不	
悄気返る	ショゲカエル	辛悲	
悄気る	ショゲル	辛悲	
ショッキング	ショッキング	悲驚	
ショック	ショック	悲驚	
しょぼしょぼ	ショボショボ	悲寂	
しょぼたれる	ショボタレル	悲寂	
しょんぼり	ションボリ	寂	
白ける	シラケル	き不失	
しらける	シラケル	き不失	
親愛	シンアイ	親好尊	
震撼	シンカン	驚	
心外	シンガイ	驚	
震駭	シンガイ	驚怖	
辛気臭い	シンキクサイ	不鬱苦	
呻吟	シンギン	苦	
辛苦	シンク	苦辛	
神経が張り詰める	シンケイガハリツメル	緊	
深謝	シンシャ	感謝	
心酔	シンスイ	尊好	
親善	シンゼン	親	
心臓が止まる	シンゾウガトマル	驚	
心中穏やかでない	シンチュウオダヤカデナイ	焦ふ	
心痛	シンツウ	心辛	
しんどい	シンドイ	辛苦	
心配	シンパイ	心	
心服	シンプク	尊	
しんみり	シンミリ	悲寂	
心労	シンロウ	心苦	
辛労	シンロウ	辛苦	
慈愛	ジアイ	尊好親	
じいんと	ジイント	動	
自棄	ジキ	失辛情	
自虐	ジギャク	悲辛	
忸怩	ジクジ	恥	
自己嫌悪	ジコケンオ	嫌	
自失	ジシツ	穏	
ジジくさい	ジジクサイ	嫌	
自若	ジジャク	安	
自責	ジセキ	嫌	
地団太を踏む	ジダンダオフム	興怒悔	
自嘲	ジチョウ	失見憐	
慈悲	ジヒ	憐	
自暴自棄	ジボウジキ	失辛情	
自慢たらしい	ジマンタラシイ	誇	
じめじめ	ジメジメ	鬱嫌	
寂然	ジャクネン	寂	
雀躍	ジャクヤク	喜	
邪魔	ジャマ	嫌	
邪魔くさい	ジャマクサイ	嫌	
充実感	ジュウジツカン	安気幸	
情	ジョウ	親	
情愛	ジョウアイ	好親尊	
情炎	ジョウエン	好興願	
上気	ジョウキ	怒	
上機嫌	ジョウキゲン	気	
情熱	ジョウネツ	興	
情欲	ジョウヨク	好興願	
焦らす	ジラス	願願怒	
じりじり	ジリジリ	不怒	
焦れったい	ジレッタイ	不	
焦れったがる	ジレッタガル	不	
焦れったさ	ジレッタサ	不	
焦れる	ジレル	不	
仁愛	ジンアイ	尊好親	
すうっと	スウット	気	
末恐ろしい	スエオソロシイ	怖ふ	
すえたのもしい	スエタノモシイ	願	
好かない	スカナイ	嫌	
清々しい	スガスガシイ	気安	
好き	スキ	好	
好き好む	スキコノム	好	
救われる	スクワレル	幸	
すごすご	スゴスゴ	失悲	
荒む	スサム	嫌	
啜り上げる	ススリアゲル	悲	
啜り泣き	ススリナキ	悲	
啜り泣く	ススリナク	悲	
すっきり	スッキリ	気	
素っ頓狂	スットンキョウ	驚	
捨て台詞	ステゼリフ	情	
捨て鉢	ステバチ	怒	
素晴らしい	スバラシイ	動	
すまん	スマン	謝	
随喜	ズイキ	喜	
図々しい	ズウズウシイ	嫌Ｆ	
杜撰	ズサン	嫌	
清清	セイセイ	気	
凄絶	セイゼツ	怖	
凄愴	セイソウ	悲	
青天の霹靂	セイテンノヘキレキ	驚	
積怨	セキエン	恨	
急き込む	セキコム	焦	
寂莫	セキバク	寂	
寂莫感	セキバクカン	寂	
積憤	セキフン	怒	
赤面	セキメン	恥	
寂寥	セキリョウ	寂	
寂寥感	セキリョウカン	寂	
せこい	セコイ	失見	
背筋が氷つく	セスジガコオリツク	怖	
背筋が凍る	セスジガコオル	怖	
世知辛い	セチツライ	辛	
切ない	セツナイ	切	
切ない思い	セツナイオモイ	切	
切なさ	セツナサ	切	
狭苦しい	セマクルシイ	苦	
責め苦	セメク	苦辛	
戦意	センイ	興	
戦々恐々	センセンキョウキョウ	ふ怖	
センチメンタル	センチメンタル	切	
羨望	センボウ	妬	
旋毛を曲げる	センモウヲマゲル	嫌不	
戦慄	センリツ	ふ怖	
戦慄感	センリツカン	ふ怖	
鮮烈	センレツ	驚	
絶句	ゼック	驚	
絶好調	ゼッコウチョウ	気	
絶体絶命	ゼッタイゼツメイ	焦失	
絶頂感	ゼッチョウカン	幸	
絶望	ゼツボウ	失鬱	
粗悪	ソアク	嫌不	
壮快	ソウカイ	気	
爽快	ソウカイ	気	
総毛立つ	ソウケタツ	怖	
相好を崩す	ソウゴウヲクズス	穏喜	
相思相愛	ソウシソウアイ	好親尊	
壮絶	ソウゼツ	気興	
騒々しい	ソウゾウシイ	嫌	
蒼白	ソウハク	辛驚	
爽涼	ソウリョウ	気	
惻隠	ソクイン	憐	
沮喪	ソソウ	失悲鬱	
嫉み	ソネミ	妬	
嫉む	ソネム	妬嫌	
空恐ろしい	ソラオソロシイ	ふ怖	
空恐ろしさ	ソラオソロシサ	ふ怖	
空空しい	ソラゾラシイ	Ｆ	
空恥ずかしい	ソラハズカシイ	恥き	
空喜び	ソラヨロコビ	喜	
そわそわ	ソワソワ	興	
憎悪	ゾウオ	憎嫌	
憎悪感	ゾウオカン	憎嫌	
俗悪	ゾクアク	嫌	
ぞくぞくする	ゾクゾクスル	興緊怖	
俗っぽい	ゾクッポイ	嫌Ｆ	
ぞっこん	ゾッコン	好親尊興焦	
ぞっとしない	ゾットシナイ	嫌	
ぞっとする	ゾットスル	怖	
存外	ゾンガイ	驚	
大慶	タイケイ	喜	
大切	タイセツ	好	
泰然	タイゼン	穏	
泰然自若	タイゼンジジャク	穏	
大息	タイソク	心残ふ困	
怠惰	タイダ	怠	
高鳴る	タカナル	興願	
高飛車	タカビシャ	嫌Ｆ	
昂り	タカブリ	興	
昂	タカブリ	興	
昂ぶる	タカブル	興	
高笑い	タカワライ	楽	
多岐亡羊	タキボウヨウ	悩	
たくましい	タクマシイ	誇	
猛り狂う	タケリクルウ	興	
猛り立つ	タケリタツ	興	
猛る	タケル	興	
多謝	タシャ	謝	
たじたじ	タジタジ	焦	
たじろぐ	タジログ	焦	
助かりました	タスカリマシタ	感	
助かります	タスカリマス	感	
立ち竦む	タチスクム	怖驚	
愉しい	タノシイ	楽	
楽しい	タノシイ	楽	
楽しかった	タノシカッタ	楽	
楽しがる	タノシガル	楽	
楽しさ	タノシサ	楽	
楽しみ	タノシミ	楽	
楽しむ	タノシム	楽	
頼もしい	タノモシイ	安尊	
たまげる	タマゲル	驚	
魂を奪われたよう	タマシイヲウバワレタヨウ	穏	
堪らない	タマラナイ	辛苦	
堪り兼ねる	タマリカネル	辛苦	
溜息	タメイキ	鬱ふ	
ため息をつく	タメイキヲツク	鬱ふ	
躊躇い	タメライ	た	
躊躇う	タメラウ	た	
揺蕩う	タユタウ	安	
弛み	タユミ	怠	
弛む	タユム	怠	
頼り無い	タヨリナイ	ふ	
頼りなさ	タヨリナサ	ふ	
嘆賞	タンショウ	尊	
嘆じる	タンジル	悲鬱	
嘆ずる	タンズル	悲鬱	
嘆声	タンセイ	悲鬱	
嘆息	タンソク	尊	
淡淡	タンタン	好気	
耽溺	タンデキ	興	
嘆美	タンビ	尊	
大悦	ダイエツ	喜	
大嫌い	ダイキライ	嫌	
大事	ダイジ	好	
大好き	ダイスキ	好	
惰気	ダキ	怠	
ダサい	ダサイ	失残	
だらしない	ダラシナイ	失残	
怠い	ダルイ	怠	
だるい	ダルイ	怠	
だれ気味	ダレキミ	怠	
だれる	ダレル	怠	
断腸の思い	ダンチョウノオモイ	願	
小さくなる	チイサクナル	き	
力を落とす	チカラオオトス	失残	
力落し	チカラオトシ	失残	
力が抜ける	チカラガヌケル	あ安	
力付く	チカラズク	興	
力強い	チカラヅヨイ	安	
力抜け	チカラヌケ	怠	
ちくちく	チクチク	辛	
縮こまる	チジコマル	怖ふ	
縮み上がる	チジミアガル	怖ふ	
恥辱	チジョク	恥	
恥辱感	チジョクカン	恥	
血なまぐさい	チナマグサイ	怖	
血の気が引く	チノケガヒク	怖	
血の涙	チノナミダ	辛悲	
血走る	チバシル	興	
血迷う	チマヨウ	悩	
チャーミング	チャーミング	尊好	
躊躇	チュウチョ	た	
惆悵	チュウチョウ	悲	
中っ腹	チュウッパラ	Ｆ怒	
寵愛	チョウアイ	好親	
弔意	チョウイ	悲寂	
悵然	チョウゼン	恨悲辛	
長嘆	チョウタン	悲ふ	
沈鬱	チンウツ	悲辛	
鎮静	チンセイ	安	
沈潜	チンセン	興	
沈着	チンチャク	興	
沈痛	チンツウ	悲辛心	
追悼	ツイトウ	悲寂	
追慕	ツイボ	悲寂好尊	
痛快	ツウカイ	気	
痛快さ	ツウカイサ	気	
痛快味	ツウカイミ	気	
痛哭	ツウコク	悲	
痛恨	ツウコン	悲	
痛心	ツウシン	悲辛	
痛惜	ツウセキ	悲が	
痛嘆	ツウタン	悲辛	
痛憤	ツウフン	怒不	
痛痒	ツウヨウ	辛	
閊えが下がる	ツカエガサガル	安	
閊えが取れる	ツカエガトレル	安	
つまらない	ツマラナイ	寂不	
つまんない	ツマンナイ	寂不	
冷たい	ツメタイ	不寂	
辛い	ツライ	辛	
辛さ	ツラサ	辛	
つれない	ツレナイ	失が	
つんつん	ツンツン	不	
つんと	ツント	不悲	
涕泣	テイキュウ	悲辛	
啼泣	テイキュウ	悲辛	
諦念	テイネン	失	
涕涙	テイルイ	悲辛	
敵意	テキイ	嫌	
敵愾心	テキガイシン	怒不	
敵視	テキシ	嫌	
照れ隠し	テレカクシ	恥喜	
照れ臭い	テレクサイ	恥喜	
照れ臭さ	テレクササ	恥喜	
照れる	テレル	恥喜	
溺愛	デキアイ	好	
吐息	トイキ	辛ふ	
陶酔	トウスイ	気	
陶然	トウゼン	気	
尊ぶ	トウトブ	尊	
当惑	トウワク	困	
ときめかす	トキメカス	願切	
ときめき	トキメキ	願切	
ときめく	トキメク	願切	
得意	トクイ	誇	
とげとげしい	トゲトゲシイ	嫌	
所得顏	トコロエガオ	誇	
妬心	トシン	妬	
飛び上がる	トビアガル	驚	
飛び退く	トビノク	驚	
途方に暮れる	トホウニクレル	困焦	
トホホ	トホホ	残	
戸惑い	トマドイ	困	
戸惑う	トマドウ	困	
取り越し苦労	トリコシクロウ	心	
取り残される	トリノコサレル	寂	
鳥肌	トリハダ	Ｆ嫌怖動	
取り乱す	トリミダス	焦	
とろい	トロイ	失見が	
蕩ける	トロケル	幸	
怒	ド	怒	
動悸	ドウキ	願喜緊	
同慶	ドウケイ	喜祝	
慟哭	ドウコク	悲	
瞠若	ドウジャク	驚	
同情	ドウジョウ	憐	
動じる	ドウジル	焦	
動顛	ドウテン	驚	
胴震い	ドウブルイ	緊怖興	
瞠目	ドウモク	驚	
動揺	ドウヨウ	驚ふ焦	
怒気	ドキ	怒	
どきっ	ドキッ	驚	
どきどき	ドキドキ	緊願驚怖	
どきり	ドキリ	驚怖喜	
どきん	ドキン	驚怖喜	
どぎつい	ドギツイ	嫌Ｆ	
どぎまぎ	ドギマギ	焦	
度肝を抜かれる	ドギモヲヌカレル	驚	
怒号	ドゴウ	怒	
怒声	ドセイ	怒	
怒鳴り込む	ドナリコム	怒興	
怒鳴り散らす	ドナリチラス	怒興	
怒鳴り付ける	ドナリツケル	怒興	
怒鳴る	ドナル	怒興	
怒罵	ドバ	怒興見	
どよめく	ドヨメク	困き	
どんより	ドンヨリ	嫌	
萎え萎む	ナエシボム	悲失不	
萎える	ナエル	悲失不	
長たらしい	ナガタラシイ	Ｆ	
泣き	ナキ	悲辛	
泣き明かす	ナキアカス	悲辛	
泣き顔	ナキガオ	辛悲	
泣き崩れる	ナキクズレル	悲辛切悔	
泣き暮らす	ナキクラス	悲辛	
泣き暮れる	ナキクレル	悲辛	
泣き込む	ナキコム	悲辛願	
泣き声	ナキゴエ	悲辛	
泣き叫ぶ	ナキサケブ	悲辛	
泣き沈む	ナキシズム	悲辛切	
泣きじゃくる	ナキジャクル	悲辛	
泣きたい	ナキタイ	悲辛	
泣き出す	ナキダス	悲辛	
泣き付く	ナキツク	悲辛願	
泣き面	ナキツラ	悲辛	
泣き泣き	ナキナキ	悲辛	
泣き濡れる	ナキヌレル	悲辛	
泣き腫らす	ナキハラス	悲辛	
泣き伏す	ナキフス	悲辛切	
泣き咽ぶ	ナキムセブ	悲辛	
泣き別れ	ナキワカレ	悲辛切寂	
泣き別れる	ナキワカレル	悲辛切寂	
泣く	ナク	悲辛喜	
泣く泣く	ナクナク	悲辛	
泣ける	ナケル	悲辛動	
嘆かわしい	ナゲカワシイ	怒不情	
嘆き	ナゲキ	悲不	
嘆き明かす	ナゲキアカス	悲不	
嘆き悲しむ	ナゲキカナシム	悲不	
嘆く	ナゲク	悲不	
和やか	ナゴヤカ	安	
名残惜しい	ナゴリオシイ	悲寂辛切	
名残惜しむ	ナゴリオシム	悲寂辛切	
情けない	ナサケナイ	情	
情けなさ	ナサケナサ	情	
馴染む	ナジム	親	
懐かしい	ナツカシイ	安寂幸	
懐かしがる	ナツカシガル	安寂幸	
懐かしさ	ナツカシサ	安寂幸	
懐かしみ	ナツカシミ	安寂幸	
懐かしむ	ナツカシム	安寂幸親	
懐く	ナツク	親安	
生唾を呑む	ナマツバオノム	緊	
涙	ナミダ	悲喜興	
涙雨	ナミダアメ	悲	
涙をのむ	ナミダオノム	辛悲	
涙が込み上げる	ナミダガコミアゲル	悲辛動	
涙ぐましい	ナミダグマシイ	憐尊	
涙ぐむ	ナミダグム	動悲辛喜	
涙声	ナミダゴエ	悲動喜	
波立つ	ナミダツ	興	
涙に掻き暗れる	ナミダニカキクレル	悲	
涙に暮れる	ナミダニクレル	悲辛切	
涙に咽ぶ	ナミダニムセブ	悲辛切	
悩まされる	ナヤマサレル	悩	
悩ましい	ナヤマシイ	悩	
悩ます	ナヤマス	悩苦	
悩み	ナヤミ	悩苦	
悩む	ナヤム	悩苦	
馴れ馴れしい	ナレナレシイ	親嫌	
難渋	ナンジュウ	苦困	
ナンセンス	ナンセンス	見失あ	
なんと	ナント	驚困	
なんとまあ	ナントマア	困	
煮え返る	ニエカエル	怒	
煮え繰り返る	ニエクリカエル	怒	
煮え立つ	ニエタツ	怒	
煮え湯を飲まされる	ニエユヲノマサレル	辛失	
苦い	ニガイ	嫌Ｆ辛	
苦いものが込み上げる	ニガイモノガコミアゲル	嫌	
苦手	ニガテ	嫌	
苦々しい	ニガニガシイ	嫌	
苦り切る	ニガリキル	嫌不	
苦る	ニガル	嫌	
苦笑い	ニガワライ	不Ｆ	
憎い	ニクイ	憎	
憎く思う	ニククオモウ	憎	
憎しみ	ニクシミ	憎	
憎たらしい	ニクタラシイ	憎	
憎体	ニクテイ	憎	
憎々しい	ニクニクシイ	憎	
憎む	ニクム	憎Ｆ	
憎らしい	ニクラシイ	憎	
憎らしさ	ニクラシサ	憎	
にこにこ	ニコニコ	喜	
にこやか	ニコヤカ	喜	
にたにた	ニタニタ	楽見喜	
にっこり	ニッコリ	喜	
二の足を踏む	ニノアシオフム	た	
にやにや	ニヤニヤ	楽	
にやり	ニヤリ	楽	
睨み付ける	ニラミツケル	嫌	
睨む	ニラム	嫌	
人情	ニンジョウ	親好	
にんまり	ニンマリ	喜幸	
糠喜び	ヌカヨロコビ	喜失	
寝苦しい	ネグルシイ	苦不	
妬ましい	ネタマシイ	妬	
妬ましがる	ネタマシガル	妬	
妬み	ネタミ	妬	
妬み憎む	ネタミニクム	妬憎	
妬む	ネタム	妬	
ねちっこい	ネチッコイ	嫌	
熱愛	ネツアイ	好興	
熱を上げる	ネツオアゲル	好興	
熱情	ネツジョウ	好興	
熱に浮かされる	ネツニウカサレル	興	
熱涙	ネツルイ	動	
悩殺	ノウサツ	悩興	
悩乱	ノウラン	悩焦	
血の気が上る	ノケガノボル	怒	
残り多い	ノコリオオイ	残寂不	
残り惜しい	ノコリオシイ	残寂不	
ノスタルジア	ノスタルジア	切苦寂	
伸び伸び	ノビノビ	安	
逆上せ	ノボセ	怒興	
逆上せ上がる	ノボセアガル	怒興	
のめり込む	ノメリコム	興	
呪い	ノロイ	辛失怒嫌	
呪う	ノロウ	嫌怒辛失	
呪わしい	ノロワシイ	嫌怒	
暢気	ノンキ	安	
のんびり	ノンビリ	安	
儚い	ハカナイ	悲切	
図らずも	ハカラズモ	驚	
歯痒い	ハガユイ	不Ｆ	
剥れる	ハガレル	怒不	
吐き気	ハキケ	嫌Ｆ	
吐気	ハキケ	嫌Ｆ	
歯軋り	ハギシリ	悔怒	
博愛	ハクアイ	好	
激しい	ハゲシイ	興	
はしたない	ハシタナイ	嫌Ｆ	
燥ぐ	ハシャグ	楽	
恥	ハジ	恥	
恥じ入る	ハジイル	恥	
恥をかく	ハジオカク	恥	
恥じらい	ハジライ	恥	
恥じらう	ハジラウ	恥	
恥じる	ハジル	恥	
恥ずかしい	ハズカシイ	恥	
恥ずかしがる	ハズカシガル	恥	
恥ずかしさ	ハズカシサ	恥	
はた迷惑	ハタメイワク	不Ｆ	
肌が粟立つ	ハダガアワダツ	動嫌	
肌に粟を生じる	ハダニアワヲショウジル	動嫌	
はっと	ハット	驚	
ハッピー	ハッピー	幸	
初恋	ハツコイ	好切鬱ふ寂悲	
鼻白む	ハナジロム	失嫌	
鼻たかだか	ハナタカダカ	誇	
はにかむ	ハニカム	恥	
腹いせ	ハライセ	怒	
腹が立つ	ハラガタツ	怒	
腹黒い	ハラグロイ	嫌	
腹立たしい	ハラダタシイ	怒不	
腹立たしさ	ハラダタシサ	怒不	
腹立ち	ハラダチ	怒	
腹立つ	ハラダツ	怒	
腹に据え兼ねる	ハラニスエカネル	怒興	
腹の虫が収まらない	ハラノムシガオサマラナイ	怒	
はらはら	ハラハラ	心	
腸が千切れる	ハラワタガチギレル	悲	
腸を抉られる	ハラワタヲエグラレル	悲	
腹を立てる	ハラヲタテル	怒不	
張り合いが抜ける	ハリアイガヌケル	残	
晴れがましい	ハレガマシイ	気誇	
晴れ晴れ	ハレバレ	気	
晴れ晴れしい	ハレバレシイ	気	
晴れやか	ハレヤカ	気	
反感	ハンカン	嫌Ｆ	
反抗心	ハンコウシン	嫌Ｆ不	
煩悶	ハンモン	悩苦	
煩労	ハンロウ	嫌不	
ばかくさい	バカクサイ	見失	
ばかばかしい	バカバカシイ	見あ失	
バカヤロー	バカヤロ?	怒	
馬鹿らしい	バカラシイ	見あ失	
ばっちい	バッチイ	嫌Ｆ	
ばつが悪い	バツガワルイ	嫌情き	
万歳	バンザイ	喜幸祝	
悲哀	ヒアイ	憐悲	
悲哀感	ヒアイカン	憐悲	
贔屓	ヒイキ	願好	
ひいひい	ヒイヒイ	苦	
冷え切る	ヒエキル	失残	
冷え冷え	ヒエビエ	寂	
冷える	ヒエル	失	
悲観	ヒカン	悲失	
僻み	ヒガミ	失悲	
僻む	ヒガム	失悲	
悲泣	ヒキュウ	悲	
卑怯	ヒキョウ	失嫌	
悲惨	ヒサン	悲憐	
悲秋	ヒシュウ	悲	
悲愁	ヒシュウ	悲鬱	
悲傷	ヒショウ	悲憐	
悲壮	ヒソウ	悲誇	
悲愴	ヒソウ	悲痛	
顰み	ヒソミ	嫌	
卑俗	ヒゾク	嫌	
悲嘆	ヒタン	悲	
悲痛	ヒツウ	悲痛辛	
一安心	ヒトアンシン	安	
人恋しい	ヒトコイシイ	寂	
人懐こい	ヒトナツコイ	親安	
ひとりぼっち	ヒトリボッチ	寂	
酷い	ヒドイ	失	
悲風	ヒフウ	悲	
悲憤	ヒフン	悲怒不	
悲鳴	ヒメイ	怖驚	
冷や汗	ヒヤアセ	恥怖緊	
ひやっ	ヒヤッ	驚怖	
冷や冷や	ヒヤヒヤ	心怖	
ひやり	ヒヤリ	怖驚緊	
拍子抜け	ヒョウシヌケ	不	
表情を強張らせる	ヒョウジョウヲコワバラセル	緊ふ	
開いた口が塞がらない	ヒライタクチガフサガラナイ	あ驚	
悲涙	ヒルイ	悲	
怯む	ヒルム	怖失	
卑劣	ヒレツ	嫌	
悲恋	ヒレン	悲	
卑猥	ヒワイ	嫌	
顰蹙	ヒンシュク	嫌	
びくっ	ビクッ	驚怖	
びくつく	ビクツク	怖ふ	
びくびく	ビクビク	怖ふ	
びくり	ビクリ	驚	
微笑	ビショウ	喜	
吃驚	ビックリ	驚	
吃驚仰天	ビックリギョウテン	驚	
憫察	ビンサツ	憐	
ぴくぴく	ピクピク	怖ふ	
ぴりぴり	ピリピリ	緊	
不安	フアン	ふ	
不安がる	フアンガル	ふ	
不安定	フアンテイ	ふ焦	
不快	フカイ	嫌	
不快感	フカイカン	嫌	
不快さ	フカイサ	嫌	
腑甲斐無い	フガイナイ	情失	
不機嫌	フキゲン	不	
不気味	フキミ	ふ怖	
不気味さ	フキミサ	ふ怖	
不興	フキョウ	不失嫌	
不謹慎	フキンシン	あ失	
膨れっ面	フクレッツラ	不	
不潔	フケツ	嫌	
耽る	フケル	興	
不幸	フコウ	辛	
鬱ぎ込む	フサギコム	鬱	
鬱ぐ	フサグ	鬱	
伏し目	フシメ	鬱悲	
不承不承	フショウブショウ	た嫌不	
父性愛	フセイアイ	好親	
吹っ切れる	フッキレル	気	
怫然	フツゼン	怒不	
ふてぶてしい	フテブテシイ	嫌Ｆ	
腑抜け	フヌケ	失	
不憫	フビン	憐	
不憫さ	フビンサ	憐	
不服	フフク	不	
不平	フヘイ	不	
不本意	フホンイ	不	
不満	フマン	不	
不満足	フマンゾク	不	
不味	フミ	不Ｆ	
不面目	フメンボク	失	
不愉快	フユカイ	不	
不愉快感	フユカイカン	不	
不愉快さ	フユカイサ	不	
ふらち	フラチ	失Ｆ	
ふらふら	フラフラ	ふ	
不慮	フリョ	驚	
奮い起こす	フルイオコス	興	
奮い立つ	フルイタツ	興	
震い付く	フルイツク	興	
震う	フルウ	辛怖	
震え上がる	フルエアガル	怖辛	
震え戦く	フルエオノノク	興願	
震えが来る	フルエガクル	興願	
震え出す	フルエダス	ふ	
震える	フルエル	怖緊	
憤慨	フンガイ	怒不	
奮起	フンキ	興	
憤激	フンゲキ	怒興	
憤死	フンシ	怒興残	
憤然	フンゼン	怒不	
奮然	フンゼン	怒興	
憤怒	フンヌ	怒不	
憤懣	フンマン	怒不	
ぶうぶう	ブウブウ	不	
不格好	ブカッコウ	嫌失	
無様	ブザマ	あ情失嫌	
憮然	ブゼン	不驚	
物騒	ブッソウ	怖ふ	
仏頂面	ブッチョウズラ	不	
ぶつくさ	ブツクサ	不	
ぶるぶる	ブルブル	怖辛	
無礼	ブレイ	怒Ｆ	
ぷいと	プイト	怒	
ぷりぷり	プリプリ	怒	
ぷんぷん	プンプン	怒	
平安	ヘイアン	安	
平穏	ヘイオン	安	
平気	ヘイキ	安	
閉口	ヘイコウ	困	
平静	ヘイセイ	安	
平然	ヘイゼン	安	
へいちゃら	ヘイチャラ	安	
辟易	ヘキエキ	嫌Ｆ	
臍を曲げる	ヘソヲマゲル	嫌Ｆ	
下手糞	ヘタクソ	失	
下手の横好き	ヘタノヨコズキ	好楽	
反吐	ヘド	嫌	
へどもど	ヘドモド	困	
偏愛	ヘンアイ	好	
べそをかく	ベソヲカク	辛悲	
法悦	ホウエツ	喜	
頬が火照る	ホウガホテル	恥幸	
放心	ホウシン	穏	
放心状態	ホウシンジョウタイ	穏	
法楽	ホウラク	楽	
頬を染める	ホウヲソメル	幸恥	
朗か	ホガラカ	楽幸	
北叟笑む	ホクソエム	楽	
ほくほく	ホクホク	幸	
誇らしい	ホコラシイ	誇	
誇らしさ	ホコラシサ	誇	
誇り	ホコリ	誇	
誇る	ホコル	誇	
綻ばす	ホコロバス	幸	
綻びる	ホコロビル	興	
綻ぶ	ホコロブ	興	
ほっと	ホット	安	
火照る	ホテル	幸恥	
仄仄	ホノボノ	幸	
微笑み	ホホエミ	喜	
微笑む	ホホエム	喜	
頬を染める	ホホヲソメル	喜恥	
褒めそやす	ホメソヤス	尊	
褒め讃える	ホメタタエル	尊	
褒めちぎる	ホメチギル	尊	
褒める	ホメル	尊	
惚れ込む	ホレコム	好興	
惚れ惚れ	ホレボレ	好興	
惚れる	ホレル	好興	
ほろっと	ホロット	動	
ほろ苦い	ホロニガイ	切悲残	
ほろほろ	ホロホロ	悲辛	
ほろり	ホロリ	悲辛	
望外	ボウガイ	喜	
呆然	ボウゼン	驚	
惘然	ボウゼン	驚	
茫然	ボウゼン	驚	
暴慢	ボウマン	不Ｆ	
亡羊の嘆	ボウヨウノタン	悩困	
慕情	ボジョウ	好焦尊	
母性愛	ボセイアイ	好親	
勃然	ボツゼン	怒	
ぼろぼろ	ボロボロ	悲辛苦	
ぼんやりする	ボンヤリスル	穏	
ぼうっとなる	ボーットナル	穏	
ぽうっとなる	ポウットナル	穏	
ぽかんとする	ポカントスル	穏	
ぽろぽろ	ポロポロ	悲辛	
ぽろり	ポロリ	悲辛	
まがまがしい	マガマガシイ	嫌Ｆ	
間が悪い	マガワルイ	きＦ	
負け惜しみ	マケオシミ	悔情	
まごつく	マゴツク	困	
まごまご	マゴマゴ	困	
まさかの	マサカノ	驚	
不味い	マズイ	失不	
貧しい	マズシイ	苦辛	
まだるっこい	マダルッコイ	不	
待ち焦がれる	マチコガレル	ふ願	
待ち遠しい	マチドウシイ	願切	
真っ暗	マックラ	怖ふ情辛	
真っ青	マッサオ	ふ怖	
真っ平	マッピラ	Ｆ嫌	
惑い	マドイ	悩	
惑う	マドウ	悩困	
惑わす	マドワス	悩困	
眩しい	マブシイ	辛Ｆ	
眉が晴れる	マユガハレル	安気	
眉根を顰める	マユネオシカメル	不ふＦ	
眉を曇らす	マユヲクモラス	心	
眉を顰める	マユヲシカメル	不ふＦ	
眉を開く	マユヲヒラク	安気	
迷い	マヨイ	悩	
迷う	マヨウ	悩	
回りくどい	マワリクドイ	不Ｆ	
満悦	マンエツ	喜	
満更でもない	マンザラデモナイ	喜	
満足	マンゾク	幸	
満足感	マンゾクカン	幸	
満面朱を注ぐ	マンメンシュヲソソグ	怒恥	
見上げる	ミアゲル	尊	
身勝手	ミガッテ	嫌Ｆ	
見下す	ミクダス	見	
見縊る	ミクビル	見	
見苦しい	ミグルシイ	嫌Ｆ	
見事	ミゴト	驚尊	
見下げる	ミサゲル	見	
惨め	ミジメ	憐	
惨めさ	ミジメサ	憐	
みすぼらしい	ミスボラシイ	憐Ｆ	
見づらい	ミズライ	Ｆ	
見染める	ミソメル	好興	
満たされる	ミタサレル	喜幸	
乱れる	ミダレル	焦不Ｆ	
満ち足りる	ミチタリル	喜幸	
みっともない	ミットモナイ	嫌Ｆ	
みっともよくない	ミットモヨクナイ	嫌Ｆ	
見惚れる	ミトレル	好興	
醜い	ミニクイ	嫌Ｆ	
見憎い	ミニクイ	嫌Ｆ	
身の毛が弥立つ	ミノケガヨダツ	怖Ｆ	
身震いがする	ミブルイガスル	怖辛ふ	
みみっちい	ミミッチイ	失見	
身悶え	ミモダエ	苦	
身悶える	ミモダエル	苦	
身も縮む	ミモチジム	怖	
未練	ミレン	失悔残	
未練がましい	ミレンガマシイ	失悔残	
身を切られる	ミヲキラレル	辛悲	
身を裂く	ミヲサク	辛悲	
むかっと	ムカット	怒	
向っ腹	ムカッパラ	怒	
向っ腹が立つ	ムカッパラガタツ	怒	
向っ腹を立てる	ムカッパラヲタテル	怒	
むかつく	ムカツク	不怒	
むかむか	ムカムカ	怒Ｆ不	
無我夢中	ムガムチュウ	興	
向きになる	ムキニナル	怒	
無気力	ムキリョク	穏	
惨たらしい	ムゴタラシイ	嫌悲	
むさい	ムサイ	嫌Ｆ	
むさくるしい	ムサクルシイ	嫌Ｆ	
蒸し暑い	ムシアツイ	辛嫌Ｆ	
虫酸が走る	ムシズガハシル	嫌	
むしゃくしゃ	ムシャクシャ	不怒	
むずかる	ムズカル	不怒	
むず痒い	ムズガユイ	嫌	
むずむず	ムズムズ	Ｆ	
咽び泣き	ムセビナキ	悲辛	
咽び泣く	ムセビナク	悲辛	
咽ぶ	ムセブ	喜悲	
噎せる	ムセル	悲辛	
夢中になる	ムチュウニナル	興	
むっと	ムット	怒	
むつまじい	ムツマジイ	親	
胸糞が悪い	ムナクソガワルイ	嫌Ｆ	
胸苦しい	ムナグルシイ	苦	
胸騒ぎ	ムナサワギ	ふ心	
空しい	ムナシイ	失	
虚しい	ムナシイ	失	
虚しさ	ムナシサ	失	
胸躍る	ムネオドル	喜興	
胸を撫で下ろす	ムネオナデオロス	安	
胸が熱くなる	ムネガアツクナル	動	
胸が痛くなる	ムネガイタクナル	辛	
胸が一杯になる	ムネガイッパイニナル	喜悲興	
胸がすく	ムネガスク	気	
胸が潰れる	ムネガツブレル	悲心辛	
胸が詰まる	ムネガツマル	苦	
胸が轟く	ムネガトドロク	願喜	
胸が弾む	ムネガハズム	喜	
胸が早鐘を打つ	ムネガハヤガネヲウツ	願喜	
胸が張り裂ける	ムネガハリサケル	辛苦切	
胸が塞がる	ムネガフサガル	ふ心辛	
胸が震える	ムネガフルエル	喜幸	
胸が悪い	ムネガワルイ	嫌不怒	
胸につかえる	ムネニツカエル	不Ｆ	
胸を痛める	ムネヲイタメル	悩	
胸を打たれる	ムネヲウタレル	動	
胸を抉られる	ムネヲエグラレル	辛苦	
胸を躍らせる	ムネヲオドラセル	喜願興	
胸を焦がす	ムネヲコガス	ふ鬱	
胸を締め付けられる	ムネヲシメツケラレル	苦切	
胸を締められる	ムネヲシメラレル	苦切	
胸を突かれる	ムネヲツカレル	驚切	
胸を膨らませる	ムネヲフクラマセル	願	
無念	ムネン	失情悔不	
無念さ	ムネンサ	失情悔不	
無念遣る方ない	ムネンヤルカタナイ	辛失情悔不	
むらむら	ムラムラ	興	
滅入り込む	メイリコム	失残	
滅入る	メイル	失残	
迷惑	メイワク	嫌Ｆ	
目が潤む	メガウルム	動喜	
目頭が熱くなる	メガシラガアツクナル	動喜	
目障り	メザワリ	不Ｆ嫌	
目尻を下げる	メジリヲサゲル	喜幸	
めずらしい	メズラシイ	驚尊	
めそめそ	メソメソ	悲辛	
めでたい	メデタイ	喜	
目に角を立てる	メニカドヲタテル	怒	
眩暈	メマイ	苦辛	
女々しい	メメシイ	不失あ	
メロメロ	メロメロ	好興	
目を白黒させる	メヲシロクロサセル	驚	
目をパチクリさせる	メヲパチクリサセル	驚	
眼を伏せる	メヲフセル	悲	
目を細める	メヲホソメル	喜幸	
目を丸くする	メヲマルクスル	驚	
目を瞠る	メヲミハル	驚	
目を剥く	メヲムク	怒	
面食らう	メンクラウ	驚	
面倒い	メンドイ	不	
面倒	メンドウ	不	
面倒臭い	メンドウクサイ	不	
面目無い	メンボクナイ	謝	
盲愛	モウアイ	好親	
申し分ない	モウシブンナイ	謝	
申し訳ない	モウシワケナイ	謝	
燃え尽きる	モエツキル	気	
もじもじする	モジモジスル	恥ふ	
悶え	モダエ	悩苦困	
悶える	モダエル	悩苦困	
もどかしい	モドカシイ	不	
もどかしがる	モドカシガル	不	
もどかしさ	モドカシサ	不	
物哀れ	モノアワレ	憐	
物憂い	モノウイ	鬱	
懶い	モノウイ	怠	
懶さ	モノウサ	怠	
物怖じ	モノオジ	怖	
物恐ろしい	モノオソロシイ	怖	
物思い	モノオモイ	鬱	
物悲しい	モノガナシイ	悲	
物悲しさ	モノガナシサ	悲	
物淋しい	モノサビシイ	寂	
物寂しい	モノサビシイ	寂	
物騒がしい	モノサワガシイ	不Ｆ	
物足りない	モノタリナイ	不	
物足りなさ	モノタリナサ	不	
貰い泣き	モライナキ	悲切	
文句を言う	モンクヲイウ	不	
悶絶	モンゼツ	苦	
悶悶	モンモン	悩苦	
喧しい	ヤカマシイ	嫌	
やきもき	ヤキモキ	妬	
焼き餅を焼く	ヤキモチヲヤク	妬	
妬く	ヤク	妬	
自棄糞	ヤケクソ	失	
灼け爛れる	ヤケタダレル	辛苦	
妬ける	ヤケル	妬	
灼ける	ヤケル	苦辛	
安らか	ヤスラカ	安	
安らかさ	ヤスラカサ	安	
安らぎ	ヤスラギ	安	
安らぐ	ヤスラグ	安	
ヤダー	ヤダー	不	
やっかい	ヤッカイ	Ｆ不	
やっかみ	ヤッカミ	妬	
やっかむ	ヤッカム	妬	
躍起	ヤッキ	興	
ヤッター	ヤッター	喜幸	
八つ当たり	ヤツアタリ	不興失	
破れかぶれ	ヤブレカブレ	不興失	
野暮ったい	ヤボッタイ	Ｆ不	
疚しい	ヤマシイ	恥Ｆ	
やむ無い	ヤムナイ	失	
やむを得ない	ヤムヲエナイ	失	
ややこしい	ヤヤコシイ	不	
遣り切れない	ヤリキレナイ	不	
遣る瀬ない	ヤルセナイ	辛悲	
遣る瀬なさ	ヤルセナサ	辛悲	
やれやれ	ヤレヤレ	情失	
友愛	ユウアイ	親	
憂鬱	ユウウツ	鬱	
憂鬱感	ユウウツカン	鬱	
憂患	ユウカン	悩心	
友誼	ユウギ	親	
憂苦	ユウク	心苦	
友好	ユウコウ	親	
憂国	ユウコク	鬱	
憂思	ユウシ	鬱	
憂愁	ユウシュウ	鬱	
幽愁	ユウシュウ	鬱	
憂色	ユウショク	鬱	
憂心	ユウシン	鬱	
友情	ユウジョウ	親	
悠然	ユウゼン	安	
悠長	ユウチョウ	安	
憂憤	ユウフン	鬱興	
憂悶	ユウモン	悩心苦	
勇躍	ユウヤク	興	
悠悠	ユウユウ	安	
悠悠閑閑	ユウユウカンカン	安	
悠揚	ユウヨウ	安	
憂慮	ユウリョ	心ふ	
愉悦	ユエツ	喜楽	
愉快	ユカイ	喜楽気	
揺さ振る	ユサブル	動	
揺す振る	ユスブル	動	
愉楽	ユラク	喜楽	
揺らぐ	ユラグ	悩鬱ふ	
揺らめく	ユラメク	悩鬱ふ	
ゆらゆら	ユラユラ	安	
ゆらり	ユラリ	安	
揺るがす	ユルガス	ふ困	
揺るがない	ユルガナイ	穏	
揺るぎ無い	ユルギナイ	穏	
揺るぐ	ユルグ	ふ困	
揺れ	ユレ	ふ困	
揺れる	ユレル	ふ困	
好い感情を持つ	ヨイカンジョウヲモツ	好親	
好い気持ちがしない	ヨイキモチガシナイ	嫌Ｆ	
好い気持ちはしない	ヨイキモチハシナイ	嫌Ｆ	
好い心持ち	ヨイココロモチ	好親	
好い心持ちはしない	ヨイココロモチワシナイ	嫌Ｆ	
酔う	ヨウ	Ｆ苦	
良かった	ヨカッタ	安	
好く	ヨク	好	
抑鬱	ヨクウツ	ふ嫌不	
欲情	ヨクジョウ	好興願	
邪	ヨコシマ	嫌Ｆ	
横恋慕	ヨコレンボ	切好苦	
慶福	ヨシトミ	幸	
好	ヨシミ	好	
よっしゃ	ヨッシャ	喜	
余憤	ヨフン	怒	
喜ばしい	ヨロコバシイ	喜	
喜ばしい訳はない	ヨロコバシイワケワナイ	喜	
喜ばしさ	ヨロコバシサ	喜	
喜	ヨロコビ	喜	
喜び	ヨロコビ	喜	
喜び狂う	ヨロコビクルウ	喜	
喜ぶ	ヨロコブ	喜	
弱り切る	ヨワリキル	困辛ふ	
弱り果てる	ヨワリハテル	困辛ふ	
弱る	ヨワル	困辛ふ	
楽	ラク	楽	
落胆	ラクタン	失残	
楽ちん	ラクチン	喜	
落莫	ラクバク	寂	
楽楽	ラクラク	楽	
落涙	ラクルイ	悲辛	
ラッキー	ラッキー	幸	
理屈っぽい	リクツッポイ	不Ｆ嫌	
離愁	リシュウ	悲寂	
立腹	リップク	怒	
慄然	リツゼン	怖	
溜飲が下がる	リュウインガサガル	気	
良好	リョウコウ	好喜	
良心が痛む	リョウシンガイタム	辛悲情	
慮外	リョガイ	嫌	
旅愁	リョシュウ	鬱	
ルンルン	ルンルン	幸	
冷静	レイセイ	穏	
恋愛	レンアイ	好興切	
恋情	レンジョウ	好興切	
廉恥	レンチ	恥	
憐憫	レンビン	憐	
恋慕	レンボ	好興切	
恋恋	レンレン	切鬱ふ寂	
労苦	ロウク	心	
狼狽	ロウバイ	困	
我がまま	ワガママ	嫌Ｆ	
沸き返る	ワキカエル	興	
沸き立つ	ワキタツ	興	
惑溺	ワクデキ	興好	
惑乱	ワクラン	焦	
わくわく	ワクワク	願	
煩い	ワズライ	悩心	
煩う	ワズラウ	悩心	
煩わしい	ワズラワシイ	悩心不	
煩わす	ワズラワス	悩心	
蟠り	ワダカマリ	不	
蟠る	ワダカマル	不	
わっ	ワッ	驚	
戦慄き	ワナナキ	怖	
戦慄く	ワナナク	怖	
わなわな	ワナワナ	興	
詫びしい	ワビシイ	寂	
佗びしい	ワビシイ	寂	
佗びしがる	ワビシガル	寂	
佗びしさ	ワビシサ	寂	
詫びる	ワビル	謝	
笑い	ワライ	喜	
笑い顔	ワライガオ	喜	
笑う	ワラウ	喜幸	
悪い	ワルイ	謝失	
悪い気がしない	ワルイキガシナイ	喜	
悪賢い	ワルガシコイ	嫌Ｆ	
悪びれる	ワルビレル	謝	
我を忘れる	ワレオワスレル	興	
わぁ	ワー	動喜	
わーい	ワーイ	喜幸	
			
			
			
			
			
			
			
			
			
			
			
			
			
			
			
			
			
			
			
